古貌古心→古道热肠
罪有应得→咎由自取
家庭祸变→萧墙之祸
环绕纠缠→缠绕
狗急跳墙→垂死挣扎
邯郸之梦→黄粱一梦
国家栋梁→中流砥柱
虎口余生→死里逃生
河东狮吼→畏妻如虎
过目不忘→过目成诵
光说不做→言而不行
出生避世→出世
扶携提拔→提携
风卷残云→狼吞虎咽
红杏出墙→不安于室
贵族子弟→王孙公子
感谢感动→感激
干涉干与→干预
冠冕堂皇→堂而皇之
忽冷忽热→乍寒乍热
好景不常→昙花一现
更深人静→夜阑人静
耕市不惊→秋毫无犯
自强不息→发奋图强
回顾回头→回首
哄传一时→一时哄动
荒诞乖张→荒唐
好人难做→善门难开
海角天涯→天涯海角
济困解危→雪中送炭
宽洪大度→央央大度
酒肉朋友→猪朋狗友
自怨自艾→怨天尤人
积厚流光→源远流长
缄默沉静→沉默
检阅校对→校阅
肌理丰盈→珠圆玉润
见色忘友→重色轻友
检核检束→检点
花花世界→十丈软红
画龙点睛→一语道破
化为乌有→子虚乌有
横征暴敛→苛捐杂税
厚貌深情→外温内厚
桂林一枝→一枝独秀
光说不练→言而不行
毂击肩摩→车水马龙
稽查查察→稽察
剪烛西窗→同窗夜语
过甚其实→名过其实
抵触触犯→冲撞
蜚短流长→闲言闲语
菲薄单薄→微薄
跌荡放诞→跌宕
胆破心惊→心胆俱寒
发生发火→发作
低声密语→交头接耳
登高一呼→振臂一呼
耳提面命→谆谆教诲
独出机杼→别出心裁
斗胆勇敢→大胆
颠倒错乱→颠三倒四
高峻陡峭→峻峭
强烈热闹→热烈
夺得冠军→独占鳌头
独身只身→单身
反璞归真→洗净铅华
感触感染→感受
干卿底事→与你何关
负薪救火→扬汤止沸
分毫不爽→一点不错
打扮服装→装束
古里古怪→阴阳怪气
根本治理→正本清源
恩惠膏泽→恩泽
额手称庆→以手加额
规规矩矩→规行矩步
灌注贯注→灌输
奉行故事→遵守习惯
放荡任气→放荡不羁
访古寻幽→探寻胜迹
回天乏术→无法复生
毫无所惧→肆无忌惮
高兴愿意→乐意
贩夫走卒→引车卖浆
倒履相迎→扫径以待
刀锯不辞→死生无惧
后生可畏→少年老成
害人不浅→贻害不浅
耕人之田→为人作嫁
自出机杼→别出心裁
构词惑众→造谣生事
奸通奸骗→奸淫
空费时日→旷日持久
美轮美奂→竹苞松茂
蛮触之争→蜗角之争
兴师动众→调兵遣将
兴致勃勃→兴高采烈
捋臂将拳→摩拳擦掌
偶一为之→逢场作戏
难望项背→瞠乎其后
莲开并蒂→双宿双飞
开门揖盗→引狼入室
礼尚往来→投桃报李
犁庭扫穴→直捣黄龙
移樽就教→移船就础?
怡然自得→悠然自得
命运运限→运气
燎原之火→星火燎原
拘留收禁→扣押
历尽沧桑→饱经风霜
柳眉倒竖→杏眼圆睁
羊质虎皮→绣花枕头
絮絮不休→絮絮叨叨
一蹴而就→一挥而就
难以估计→无法计算
狼狈而逃→抱头鼠窜
徇情枉法→徇私舞弊
沐猴而冠→衣冠禽兽
令人着迷→引人入胜
磨铁成针→水滴石穿
魄散九霄→魂飞天外
名利双收→求名求利
切切私语→喁喁私语
年幼无知→少不更事
平坦大路→康庄大道
绵力薄材→绵力
钳形进攻→左右夹攻
烂醉如泥→玉山颓倒
一刀两断→薪尽火灭
两姓之好→秦晋之好
宽贷豁免→宽免
抛戈弃甲→抱头鼠窜
解民倒悬→拯民水火
力大无穷→孔武有力
街市商人→市井
油头滑脑→油嘴滑舌
见笑于人→贻笑大方
鹿车共挽→夫唱妇随
决议计划→决策
落拓不羁→不拘小节
教授教养→教学
开宗明义→开门见山
截趾适履→削足就履
联系关系→关联
老朽无能→尸居余气
积不相容→势如水火
举措措施→设施
唇红齿白→朱唇皓齿
应机立断→当机立断
枷锁束缚→桎梏
截趾适屦→削足就履
稽察查察→稽查
见识浅短→少见多怪
化尽心血→费尽心机
怀璧其罪→象齿焚身
救火投薪→扬汤止沸
空言无补→纸上谈兵
精神萎顿→萎靡不振
积羽沉舟→聚蚊成雷
旅行剧团→巡回剧团
娇羞答答→羞人答答
江中钓月→海底捞针
宽大旷达→豁达
进步前辈→先进
缘木求鱼→刻舟求剑
疾足先得→捷足先登
兰摧玉折→哲人其萎
血流漂杵→血流成河
绝不屈服→百折不挠
绝路末路→死路
骊歌高唱→阳关三迭
尽收眼底→一览无余
饥肠辘辘→大肠告小肠
可大可小→小大由之
聚会会议→集会
金樽旨酒→玉液琼浆
金石之盟→山盟海誓
汲深绠短→心余力绌
流芳千古→万古长青
空地空闲→空隙
老少无欺→童叟无欺
牢骚满腹→怨气冲天
决心信念→信心
进步神速→一日千里
紧密亲密→密切
立杆见影→吹糠见米
见猎心喜→跃跃欲动
义正辞严→理直气壮
义正词严→理直气壮
口血未干→言犹在耳
混淆视听→混淆黑白
决然毅然→断然
襟怀胸襟→胸怀
景象形象→气象
激昂大方→慷慨
凌云壮志→志薄云霄
梨园子弟→戏剧演员
冷暖自知→心里有数
言行相诡→口是心非
言出法随→执法如山
开山祖师→鼻祖
举国同心→万众一心
料事如神→臆则屡中
立竿见影→吹糠见米
狼狈万状→狼狈不堪
风马不接→风马牛不相及
登峰造极→至高无上
出头具名→出面
斗粟囊金→米珠薪贵
跌宕放诞→跌荡
寸男尺女→一男半女
除污去垢→荡瑕涤秽
发上指冠→怒发冲冠
诡辞欺世→妖言惑众
作壁上观→袖手旁观
国色天香→天姿国色
激动慷慨→激昂
脚踏两船→投机取巧
兵多将广→军多将广
剑拔弩张→一触即发
姑息养奸→养虎遗患
火中取栗→为人作嫁
回头是岸→悬崖勒马
气势→威风凛凛
炉火纯青→出神入化
螳臂当车→以卵击石
狗彘不若→猪狗不如
坚持到底→贯彻始终
祸不单行→灾患丛生
正人君子→正派人物
正襟危坐→态度严肃
命途坎坷→偃蹇困穷
清规戒律→金科玉律
罗敷有夫→有夫之妇
节节失利→着着失败
面目可憎→言语无味
芒刺在背→如坐针毡
洁身自爱→守身如玉
孑然一身→形单影只
脑满肠肥→大腹便便
斤斤计较→琐屑较量
不同凡响→与众不同
超群脱俗→逸群绝俗
兵出无名→师出无名
安枕无忧→高枕无忧
安分守纪→循规蹈矩
迷途知反→觉返迷津
量力而行→实事求是
年轻力壮→手轻脚健
乐极生悲→兴尽悲来
不翼而飞→不知去向
谙熟门路→老马识途
片纸只字→一鳞半爪
鸟尽弓藏→兔死狗烹
逆来顺受→唾面自干
明辨是非→是非分明
论功行赏→照功行赏
鼠肚鸡肠→小肚鸡肠
百思不解→大惑不解
不足介意→无足挂齿
傲雪欺霜→坚贞不屈
风烛残年→行将就木
花言巧语→甜言蜜语
轰轰烈烈→大张旗鼓
功效如神→万试万灵
八面受敌→四面楚歌
八怪七喇→稀奇古怪
八百壮士→四行孤军
伏枥守株→乐道安贫
分秒必争→争分夺秒
宁当玉碎→宁死不屈
暗箭伤人→含沙射影
合情合理→通情达理
八方受敌→四面楚歌
奴颜媚骨→卑躬屈膝
迷迷糊糊→模模糊糊
情不自禁→不由自主
斗志昂扬→意气风发
目迷五色→眼花撩乱
齿豁头童→老态龙钟
步步为营→稳扎稳打
全神贯注→聚精会神
破涕为笑→转悲为喜
精神奕奕→神采奕奕
精力充沛→精神抖擞
良莠淆杂→龙蛇混杂
良药苦口→忠言逆耳
乐天知命→安分守己
撤退退却→后退
牛鼎烹鸡→大材小用
程门立雪→尊师重道
不偏不倚→中庸之道
垂头丧气→没精打采
无边无涯→无边无际
纤尘不染→一尘不染
常备不懈→枕戈待旦
马不停蹄→快马加鞭
不乏其人→不胜枚举
百密一疏→鸭蛋虽密也有缝
传说风闻→传闻
大马金刀→大刀阔斧
不能自休→欲罢不能
不敢则声→吞声忍气
不合错误→不对
达官贵人→王侯将相
楚楚可怜→我见犹怜
巢木居野→穴居野处
不以为意→漫不经心
不迟不疾→从容不迫
冰天雪地→雪窖冰天
百无禁忌→童言无忌
爱才如命→求贤若渴
才气纵横→天才横溢
不识时变→不识时务
波澜壮阔→汹涌澎湃
鞭辟入里→入木三分
藏身安身→存身
春景春色→春光
不言而喻→不问可知
吹箫吴市→沿门托钵
冰炭不洽→水火不容
垂馨千祀→流芳百世
出阁之喜→于归之喜
仇隙在心→中怀怨恨
尺幅千里→掌上河山
趁波逐浪→随波逐流
代办署理→代理
出言如山→一言九鼎
耳食之言→以讹传讹
弹指之间→转瞬之间
标题问题→题目
不久不多→未几
不安于位→不守妇道
草木惊心→惊弓之鸟
刺目耀眼→刺眼
春花秋月→月下花前
刀头舔血→刀口上舔血
蟾宫仙子→月里嫦娥
电光石火→稍纵即逝
畅通流畅→流通
赤血丹心→忠肝义胆
分文不取→一钱不受
厚颜无耻→恬不知耻
好事多磨→鲜花易谢
豪侠好义→英雄仗义
吊民伐罪→除暴安良
随心所欲→为所欲为
鬼头鬼脑→鬼鬼祟祟
翠绕珠围→珠光宝气
锄强扶弱→振弱除暴
大权在握→大权独揽
爱才若命→求贤若渴
敲诈勒索→巧取豪夺
踏踏实实→脚踏实地
嫁祸于人→以邻为壑
济困扶危→雪中送炭
丰功伟绩→劳苦功高
半吐半吞→欲言又止
獐头鼠目→蛇头鼠眼
继往开来→承前启后
风驰电掣→追风逐电
合浦还珠→失而复得
寡廉鲜耻→恬不知耻
貌合神离→同床异梦
嫁祸他人→以邻为壑
不免难免→未免
不得善终→天诛地灭
不识一丁→不识之无
不用着急→毋须着急
不断改进→精益求精
鄙俗不堪→俗不可耐
虫鸣水沸→蜩螗沸羹
岔路支路→歧路
不成体统→有失体统
安守故常→安分守己
白费心血→枉费心机
比手划脚→指手画脚
搬弄是非→挑拨离间
布衣之交→微时之交
不辱使命→幸不辱命
软土深掘→得寸进尺
文房四宝→纸墨笔砚
依人篱下→为人作嫁
设法主意→想法
天罗地网→网罗密布
丧心病狂→丧尽天良
上山作贼→落草为寇
死生之契→啮臂之交
秋高气爽→天高气爽
同心专心→一心
徒托空言→托之空言
权势巨子→权威
上行下效→言传身教
忍辱含垢→含垢忍辱
疏通沟通→疏导
携手合作→通力进行
送往迎来→送旧迎新
前途难料→未定之天
破碎摧毁→粉碎
明白昭彰→彰明较着
难兄难弟→一丘之貉
私刑逼供→屈打成招
难听逆耳→刺耳
恰如私愿→正中下怀
市井之徒→屠狗之辈
弃旧容新→吐故纳新
塞翁失马→因祸得福
生活生计→生涯
全无所闻→一无所知
润泽津润→滋润
无所作为→碌碌无为
伤风败俗→有伤风化
冒名行骗→招摇撞骗
气量气度→心胸
同病相怜→惺惺相惜
弄柳拈花→拈花惹草
目下十行→一目十行
少年事重→少年老成
谬误百出→丝毫不爽
全无分别→一丘之貉
犬牙相制→犬牙交错
所在多有→不一而足
妙语如珠→妙语连珠
明天将来→来日
难熬难过→难受
随随便便→马马虎虎
目即成诵→过目成诵
收拾整顿→整理
难以决断→委决不下
心慌意乱→方寸已乱
望而却步→望而生畏
升堂入室→造诣高深
亲信背叛→舟中敌国
授人以柄→倒持泰阿
如何了局→伊于胡底
书不宣意→言不尽意
一往无前→勇往直前
随从跟随→跟从
逍遥法外→逃出法网
心如刀割→痛澈心脾
天下太平→天下升平
天地之别→天壤之别
南征北战→出生入死
清风明月→月白风清
束身待罪→引颈就戮
文过饰非→掩罪藏恶
望尘莫及→瞠乎其后
山林隐士→野鹤闲云
所嫁非人→遇人不淑
同宗同气→同出一脉
受人以柄→倒持泰阿
忍尤含诟→含垢忍辱
蜃楼海市→空中楼阁
日夜勉→夙夜匪懈
四肢举动→手脚
目挑心招→眉目传情
添枝接叶→添油加醋
穷力尽心→仁至义尽
室迩人遐→人去楼空
片言立决→一语而解
尸祝代庖→越权代理
生气希望→生机
矢口不移→一口咬定
体系体例→体制
消声匿迹→偃旗息鼓
暮景暮年→晚景
善自为谋→自作打算
市道市情→市面
色授魂与→心醉情移
神工鬼斧→天造地设
死生之交→啮臂之交
滔滔而至→源源而来
双管齐下→左右开弓
前因后果→来龙去脉
伤弓之鸟→惊弓之鸟
三令五申→再三告诫
沁人肺腑→沁人心脾
曲曲折折→弯弯曲曲
贴心贴腹→推心置腹
泼油救火→火上加油
攀辕卧辙→遮道挽留
食玉炊桂→米珠薪贵
无意偶尔→偶然
破口大骂→扬声恶骂
腾云跨风→腾云驾雾
歪歪扭扭→歪七扭八
土着土偶→土人
投鼠忌器→有所顾忌
渗入渗出→渗透
息事宁人→相安无事
舐犊情深→老牛舐犊
清算计帐→算帐
嬉皮笑脸→喜笑颜开
瓦釜雷鸣→小人得志
喜逐颜开→笑逐颜开
痛苦悲伤→疼痛
匹夫之勇→血气之勇
心灰意冷→意气消沉
收视反听→专心致志
目力眼光→眼力
倾尽国库→悉索敝赋
心花怒放→兴高采烈
世道沦亡→人心不古
罔顾情面→打狗不看主人面
乌烟瘴气→一塌糊涂
沐雨栉风→吸风饮露
药石之言→针砭之语
披麻带孝→拖麻拽布
一窍不通→一无所知
世易时移→事过境迁
配药师→药剂师
不成材→不长进
独立国→自主国
布掸子→拂尘
雄赳赳→气昂昂
女强人→铁娘子
孔方兄→阿堵物
高利贷→印子钱
不雅观→不雅
救火员→消防员
飘飘然→由由然
日曜日→星期日
千里镜→望远镜
下战书→下午
囊中物→瓮中鳖
怪样子→四不像
论说文→议论文
检阅场→演武厅
挥挥手→招招手
立崖岸→傲岸
伐柯人→媒人
发酒疯→撒酒疯
阶下囚→囚徒
卡脖子→洽商
练习生→养成工
悄悄的→偷偷的
老花子→叫花子
导火线→引火线
女儿态→脂粉气
不忘本→有良心
藏书楼→图书馆
撮合山→月老祠
陈列所→展览场
空口说→空谈
稻粱谋→衣食计
农家子→田舍郎
釜中鱼→俎上肉
不成才→不长进
生力军→新力量
不要紧→没关系
体育场→运动场
黑沉沉→阴森森
第一版→初版
博览会→展览会
钱树子→摇钱树
大年节→除夕
不够格→未入流
慈善家→善士
坦克车→装甲车
湿淋淋→湿漉漉
打盹儿→瞌睡
木曜日→星期四
爬虫类→爬行动物
大礼服→燕尾服
初级→低级
泉台→墓穴
刺目→刺眼
公家→公众
骄恣→骄纵
不乱→稳定
改行→转业
圣旨→诏书
试探→摸索
潜逃→叛逃
浮泛→空洞
苍头→厮役
简要→扼要
恬澹→淡泊
容隐→包庇
虽然→固然
十日→旬日
介入→参与
池沼→沼泽
哈腰→弯腰
春秋→年龄
首级→首领
知足→满足
村夫→乡人
赏格→悬赏
公开→公然
当真→认真
服帖→帖服
倒置→颠倒
等于→即是
清水→净水
轻盈→轻巧
底本→蓝本
春风→东风
羁縻→笼络
地道→隧道
典礼→仪式
刚烈→刚强
怯夫→懦夫
赶上→遇上
穿戴→穿着
黑色→玄色
下落→着落
热潮→高潮
盛装→艳服
征聘→征请
生果→水果
进口→入口
甜美→甜蜜
岁入→岁收
至宝→珍宝
思惟→思想
折中→折衷
珍藏→收藏
戎行→军队
诉苦→抱怨
仙人→神仙
疾走→狂奔
封锁→封闭
向阳→朝阳
邪念→杂念
什物→实物
合法→正当
高见→卓识
彻骨→透骨
公愤→众怒
关闭→封闭
奼女→少女
吉利→吉祥
假寓→定居
埋怨→抱怨
超额→逾额
爽朗→开朗
病院→医院
别号→别名
清淡→平淡
编缉→主笔
灰暗→昏暗
数量→数目
正视→重视
近世→晚世
生育→生养
私家→私人
饕戾→凶婪
不多→未几
迁就→将就
天色→天气
不外→不过
衰老→朽迈
惨怆→惨恻
假话→谎言
雠正→厘正
蹇滞→困阻
接风→拂尘
功臣→元勋
戎狄→蛮夷
交恶→反目
识相→知趣
世人→众人
释放→开释
打盹→瞌睡
垂怜→怜爱
吹打→奏乐
守信→取信
报歉→道歉
唐突→冒昧
波澜→波涛
长子→宗子
白叟→老人
泊车→停车
操作→操纵
尝尝→试试
辱没→屈辱
泊岸→靠岸
枢路→要津
绳子→绳索
如斯→如此
施医→赠医
报命→应命
统一→同一
保藏→收藏
揣想→悬想
哔叽→羽缎
初春→早春
健忘→忘记
吹奏→演奏
束装→整装
傍观→旁观
团聚→团圆
手表→腕表
抽烟→吸烟
清癯→清瘦
稀薄→淡薄
不偶→数奇
编纂→编辑
片段→片断
禀承→遵奉
倡寮→妓院
手刺→名片
暴风→狂风
书厨→书柜
日夜→昼夜
才人→秀士
安泰→安乐
迟早→早晚
步履→行动
天佑→天助
操持→筹划
操行→品行
储藏→蕴藏
凸起→突出
赐赉→赐予
床笫→枕席
侨民→外侨
亲属→支属
庶民→百姓
嘶哑→沙哑
潜在→潜伏
松散→疏松
清秀→秀气
掏出→取出
茕居→独居
依从→允从
别传→外传
随俗→顺俗
过时→过期
含蓄→蕴藉
陷溺→沉迷
沉浸→沉醉
绅士→名流
寒微→微贱
长夜→永夜
称疾→托病
畅谈→泛论
施主→檀越
鼎盛→壮盛
发烧→发热
侵蚀→腐蚀
长日→永日
厄运→恶运
青蛙→田鸡
包抄→包围
笔迹→字迹
牲畜→牲口
天然→自然
体裁→文体
比拟→相比
替身→替人
饱食→餍饫
恶梦→噩梦
恰谈→洽商
仕进→做官
等闲→轻易
扼杀→抹杀
发还→发回
反常→变态
轻蔑→藐视
熟年→丰年
半途→中途
筹措→张罗
显贵→权贵
驰誉→驰名
书橱→书柜
庇荫→荫庇
防备→防御
眺望→远望
愣住→停住
审视→审阅
惊疑→惊奇
疲劳→疲惫
增援→支援
挖苦→讥讽
疑惑→迷惑
破灭→幻灭
叹恨→怨嗟
简朴→简单
温和→温顺
耀眼→刺眼
准备→预备
如果→假如
告别→离别
气愤→生气
胜负→胜败
灾害→灾难
冲毁→冲垮
淹没→沉没
抵挡→抵抗
暴躁→急躁
悄悄→静静
形状→外形
打扰→打搅
严肃→严厉
侮辱→欺侮
强盛→强大
夸耀→炫耀
灌溉→浇灌
投契→投机
长进→上进
替代→替换
田单→田契
常人→凡人
丽人→美人
腼腆→忸怩
同志→同道
年迈→年老
乱世→浊世
成全→玉成
洁白→雪白
不决→未定
提高→进步
特意→特地
完稿→脱稿
响马→盗贼
起点→出发点
同僚→同寅
凝滞→呆滞
小童→幼童
鄙陋→猥琐
长官→主座
情谊→友谊
允许→答应
祭祀→祭奠
无端→无故
劫难→灾难
崎岖→坎坷
焦急→焦虑
看守→看管
雄伟→宏伟
严峻→严重
战役→战争
温暖→暖和
安谧→静谧
奇特→奇异
掠过→擦过
舒展→伸展
偶尔→偶然
侦探→侦察
环游→周游
寻常→平常
感触→感慨
挚友→好友
赏给→赐给
继承→继续
痛快→愉快
兴趣→爱好
惬意→舒服
疲倦→倦怠
家景→家境
凝视→注视
徐徐→渐渐
犹如→如同
掌握→把握
奇怪→希奇
糟蹋→糟践
镇定→镇静
思索→思考
气魄→气势
吓唬→恐吓
常常→经常
注意→留意
诚实→老实
长处→优点
笑容→笑脸
周围→四周
立刻→立即
凝结→凝聚
敏捷→灵敏
用心→专心
挣脱→摆脱
庄严→庄重
新颖→新奇
矗立→耸立
宽阔→宽广
中央→中心
撤职→革职
摇晃→摇摆
利便→方便
智慧→聪明
容易→轻易
训练→练习
准确→正确
收容→收留
守法→遵法
高兴→兴奋
打碎→打坏
边缘→边沿
便服→燕服
潮湿→湿润
谙熟→谙习
按摩→推拿
案牍→文案
暗斗→冷战
贵人→朱紫
暗影→阴影
后辈→子弟
梗阻→阻塞
勉强→委曲
明示→昭示
募集→召募
特效→殊效
暗射→影射
土风→乡俗
暗香→幽香
推销→倾销
使气→负气
详细→具体
飞翔→翱翔
慈祥→慈爱
农夫→农民
听见→闻声
荒芜→荒凉
安葬→埋葬
恐惊→恐惧
坚决→果断
寒冷→严寒
突然→忽然
赶快→赶紧
来回→往返
难听→刺耳
瞻望→展望
时事→时势
得意→自得
芬芳→芳香
苟安→偷安
膏腴→腴膏
合力→协力
和婉→柔顺
寒气→冷气
合理→公道
厚酬→重酬
妄言→妄语
丰满→饱满
恭顺→恭敬
谜底→答案
遨游→翱翔
傲睨→渺视
弄璋→梦熊
推寻→推求
复习→温习
跳舞→舞蹈
田猎→野猎
哀求→请求
挽救→拯救
安顿→安置
幽静→清幽
纯熟→熟练
依赖→依靠
抚摸→抚摩
相宜→适宜
贵重→珍贵
清晰→清楚
仍旧→仍然
轻微→稍微
寄居→借居
恬静→舒适
陶醉→沉醉
冰凉→冰冷
挺秀→挺拔
不凡→非凡
相称→相当
娘家→外家
外埠→外地
旁门→歪路
偏袒→左袒
把柄→痛处
颤动→颤抖
自在→安闲
暗里→私下
捕获→捕捉
判断→判定
管理→治理
小扣→轻敲
按期→定期
满意→满足
评比→评选
证明→证实
整齐→整洁
遇到→碰到
海疆→海域
毕竟→究竟
新居→新房
认识→熟悉
闻名→著名
好像→似乎
赛过→胜过
每天→天天
保留→保存
通风→透风
绝技→特技
预测→猜测
震惊→震动
淘气→调皮
奇丽→秀丽
疾驰→奔驰
洒脱→潇洒
柔美→优美
供应→供给
附近→四周
辛苦→辛劳
听从→服从
直立→竖立
笨重→粗笨
精彩→出色
舒畅→愉快
预报→预告
午睡→昼寝
惊叹→赞叹
声名→申明
接踵→相继
桀→凶悍
授室→娶妻
皆宜→咸宜
笼盖→覆盖
捐募→捐献
殷勤→周到
幽谷→深谷
弘远→远大
擅权→专权
仰给→仰食
荆布→糟糠
渴想→渴望
腊月→尾月
略坐→小坐
梨园→戏班
腊肠→香肠
枢纽→关键
阶梯→门路
伎痒→跃跃欲试
抓住→捉住
好比→比如
厚味→美味
耸然→屹然
晖映→照耀
回音→覆信
信奉→信仰
酒保→侍者
通信→通讯
娇纵→骄纵
或曰→或谓
划定→规定
记实→记录
纪行→游记
王孙→天孙
回禄→祝融
挽劝→劝说
叫化→求乞
凶事→丧事
疏浚→疏通
烈焰→炎火
破烂→褴褛
搅浑→混淆
商业→贸易
梳妆→打扮
晋升→提升
失常→变态
铺张→浪费
恍惚→模糊
间断→中断
狼藉→散乱
起飞→腾飞
投亲→探亲
架空→排挤
滚动→转动
收尾→扫尾
流动→活动
失仪→失礼
惊骇→恐惧
饥馑→饥荒
今日→本日
良久→很久
抬举→提拔
蜜意→深情
出产→生产
侍从→随从
内衣→亵服
南风→熏风
招安→招抚
澈底→透澈
正人→君子
塌台→垮台
冷笑→嘲笑
离席→退席
凉气→冷气
留存→保存
髫龄→龆年
纵贯→直通
珍异→珍奇
排遣→排解
白皙→白净
抒情→抒怀
成本→本钱
送达→投递
差劲→低劣
年青→年轻
乞降→求和
外援→外助
拜访→造访
本分→天职
布衣→平民
部门→部分
凹地→洼地
白话→口语
挨饿→受饿
麻木→麻痹
暮景→晚景
删省→删节
浓艳→冶艳
叹惜→叹惋
启齿→开口
顺路→顺道
失贼→失窃
痴钝→迟钝
沉闷→烦闷
按捺→抑制
审讯→审判
联盟→同盟
搪突→冒犯
海内→国内
充满→布满
赠送→赠予
惊讶→惊奇
违背→违反
必需→必须
保守→守旧
天黑→入夜
失踪→失落
失机→失时
无邪→天真
不合→分歧
笔直→笔挺
晨风→晓风
安分→循分
飘流→流浪
难看→丢脸
灵通→通达
废话→空话
妊妇→孕妇
出事→失事
法度→法式
存案→备案
当即→立即
调拨→挑唆
调子→音调
阻梗→阻当
服毒→仰药
勾勒→勾画
翻腾→翻滚
冬风→北风
毒杀→鸩杀
独身→单身
顿挫→抑扬
赏识→欣赏
浊流→污流
贯穿→贯串
戍卫→卫护
联袂→携手
傍门→歪路
收成→收获
积压→积存
谨严→谨慎
进款→入款
一一→逐一
利落→爽利
次日→越日
动静→消息
独有→独占
断魂→销魂
处死→正法
缔姻→联婚
深挚→深厚
粗拙→粗糙
奢靡→奢侈
打通→买通
地蜡→白蜡
宣布→公布
平等→同等
篱笆→竹篱
讲演→报告
气焰→气势
优势→上风
恰是→正是
九月→玄月
揄扬→吹嘘
愚拙→呆笨
蕴蓄→积聚
曲解→误解
漏掉→遗漏
郁悒→愁闷
精髓→精华
距离→间隔
寂聊→枯寂
显著→明显
寄身→托身
矜持→自持
路过→途经
遴派→选派
流放→放逐
军功→战功
气度→心胸
立名→扬名
激辩→舌战
因为→由于
拒守→把守
缴获→缉获
浸礼→洗礼
溘然→忽然
乐岁→丰年
郊游→远足
困倦→困乏
良俦→良伴
老拙→老朽
江山→山河
领港→引港
货泉→货币
轿子→肩舆
监督→监视
秘要→机密
起码→最少
葬送→断送
旧道→古道
嫖妓→冶游
老是→总是
修好→修睦
惧罪→畏罪
悦耳→动听
拷打→鞭挞
宽解→宽心
克扣→剥削
歉仄→抱歉
尽忠→效忠
浪人→游勇
率性→任性
立场→态度
披发→散发
集团→团体
奸骗→奸淫
脸红→酡颜
据有→占有
连络→连系
经由→经过
口吻→口气
计帐→算帐
极目→纵目
几回→几次
进级→升级
救兵→援军
再版→重版
精晓→精通
门徒→徒弟
马脚→破绽
剿袭→袭取
黑货→私货
预赛→初赛
远离→阔别
气息→气味
酒徒→醉翁
壅塞→阻塞
剧场→戏院
尖利→尖锐
中听→入耳
机能→性能
孝顺→孝敬
家传→祖传
呼啸→咆哮
隐忍→哑忍
气候→天气
辑穆→和睦
舅家→外氏
划子→小船
火药→炸药
叫声→啼声
最终→终极
出顶→召盘
年成→年景
抽剥→剥削
机杼→心裁
难题→困难
奖惩→赏罚
辑睦→和睦
中兴→复兴
接壤→交界
紧紧→牢牢
做作→造作
知名→着名
镇压→弹压
军备→武备
住持→方丈
其实→实在
欢忻→忻忭
空白→空缺
空论→空话
检阅→校阅阅兵
荏弱→柔弱
巨匠→大师
器具→用具
钱庄→银号
谨防→严防
捷报→喜报
孑遗→余存
设法→想法
计策→计谋
检修→检验
桀黠→狡猾
浪荡→游荡
蒲月→五月
缄默→沉默
假称→托辞
湔雪→洗雪
旧病→宿病
假货→赝品
话旧→叙旧
浑朴→浑厚
嫁祸→移祸
目眩→眼花
克意→锐意
话筒→发话器
豁免→宽免
季子→幼子
排击→排挤
肋膜→胸膜
蜡烛→烛炬
污吏→贪吏
盘考→盘问
冷视→漠视
增补→补充
纳贡→进贡
每日→逐日
类别→种别
亲自→亲身
亢旱→久旱
良多→很多
下班→放工
浓烈→浓郁
媒婆→牙婆
礼拜→星期
溺职→渎职
无限→无穷
老生→须生
食物→食品
弄法→玩法
旷废→荒废
匡助→帮助
夸姣→美好
落款→题名
盘剥→剥削
抛却→放弃
密意→深情
啰唆→噜苏
碰劲→碰巧
迫临→逼近
批颊→掌掴
裂痕→裂缝
努目→瞪眼
念头→动机
枪弹→子弹
母丧→丁忧
美丑→妍媸
凶兆→恶兆
麻布→夏布
逆命→抗命
雪耻→雪恨
奇观→异景
平话→说书
泥像→塑像
兰梦→梦熊
攫取→掠夺
良知→知己
面前→眼前
昆裔→后代
款接→延接
轮回→循环
康年→丰年
炼坊→冶坊
临近→邻近
领巾→围巾
休止→停止
清点→盘点
卵形→椭圆形
綦严→严紧
癖好→嗜好
骗财→诈财
预付→预支
介绍→先容
飘动→飞舞
酒杯→羽觞
披露→表露
旷地→空地
老景→晚景
羞怯→羞涩
酷刑→严刑
冷巷→小巷
逻骑→侦骑
军师→智囊
另娶→再娶
涓滴→丝毫
慨诺→允承
排闼→推门
雀斑→斑点
祸首→罪魁
优胜→优越
兼并→吞并
元凶→首恶
介弟→令弟
犒赏→赏赐
盲眼→瞎眼
旧事→往事
枯坐→闲坐
进谒→投刺
抉剔→挑剔
结子→结实
借鉴→鉴戒
卵翼→庇护
贞洁→纯洁
旷课→缺课
礼聘→聘请
立异→创新
胪陈→详述
滥调→谰言
求全→责备
纳贿→受贿
目生→陌生
肉痛→心痛
切身→亲身
旭日→朝阳
辚轹→践踏
平均→均匀
刷洗→洗擦
前贤→先哲
就绪→停当
书画→字画
朴重→正直
伶丁→孤苦
面试→口试
礼仪→礼节
涕零→涕泣
烈士→义士
书箧→书箱
许多→很多
毛笔→羊毫
锦绣→美丽
肉瘤→赘瘤
啰嗦→烦琐
漫游→周游
可托→可信
目炫→眼花
老儒→夙儒
津贴→补助
津润→滋润
了债→清偿
严惩→重办
力量→气力
临摹→摹仿
谦谢→逊谢
斗室→小房
前驱→先驱
蹊径→门路
打针→注射
典质→抵押
掉包→偷换
少憩→暂休
吊挂→悬挂
恶相→凶相
奉劝→劝告
道别→作别
碉堡→堡垒
定亲→订婚
蕃庑→茂盛
犯错→出错
房钱→租金
废料→废物
风筝→鹞子
道士→羽士
的当→确当
辞意→文意
房子→屋子
仿单→说明书
倾泻→倾注
顶用→中用
仍是→还是
儿歌→童谣
法宝→宝贝
蕃芜→茂盛
前景→远景
下昼→下午
风流→风骚
负疚→抱歉
恶棍→无赖
法场→刑场
泛博→广大
菲敬→菲仪
词目→似义词
渡过→度过
蠹虫→蛀虫
端的→真个
刚好→恰好
地志→舆志
鼎力→大力
毒酒→鸩酒
堵截→切断
锻造→铸造
细目→详目
发笑→失笑
据守→扼守
嘉会→盛会
栖身→居住
诡辩→狡辩
喝酒→饮酒
贵爵→王侯
国是→国事
格局→格式
佛门→空门
服饰→衣饰
地图→舆图
鼎峙→鼎立
受惠→沾恩
毒手→辣手
房契→宅券
丰硕→丰富
风闻→传闻
膏壤→沃土
放火→纵火
洞居→穴居
飞跃→奔腾
闲逸→散逸
刀兵→兵器
请帖→请柬
丁壮→壮年
山洞→岩穴
测量→丈量
乌黑→黝黑
寸→微暇
惩恶→劝善
处女→童贞
大公→至公
大篆→籀文
强调→夸大
岂非→难道
惩治→惩办
私交→私情
答谢→报答
苍莽→苍茫
长生→永生
饶富→富足
尺度→标准
冲刷→冲洗
参谋→顾问
大军→雄师
乘机→伺机
持禄→尸位素餐
成仙→羽化
认为→以为
步队→队伍
搀扶→扶持
丛集→猬集
渗入→渗透
独一→唯一
地舆→地理
斗丽→争艳
下世→来世
出缺→有缺
纯挚→纯真
飞驰→飞奔
费用→用度
丹青→图画
到手→得手
打动→感动
发窘→发慌
烦厌→腻烦
出险→脱险
垂垂→渐渐
色泽→光彩
催讨→追讨
大骂→痛骂
切当→确切
长短→是非
呈文→报告
晨安→早安
但愿→希望
顶嘴→顶撞
二月→仲春
人道→人性
带同→携同
死谏→尸谏
订亲→订婚
山人→隐士
多灾→多难
皇帝→天子
哗笑→喧笑
寄意→寓意
评话→说书
拙笔→秃笔
光棍→王老五骗子
豪气→英气
合用→适用
供献→进献
呵→斥责
规语→箴言
后世→后代
豪侈→奢侈
住手→停止
生成→天生
膏火→学费
灌水→注水
请客→宴客
海角→天涯
舌人→译员
闪开→让开
毫光→光芒
红霞→彤霞
虎睨→鹰视
花匠→园丁
回身→转身
问题→题目
嫁奁→嫁妆
混蛋→忘八
忤逆→违逆
交壤→交界
咭片→名片
期近→在即
耐劳→刻苦
骄易→轻慢
龋齿→蛀牙
姑苏→苏州
糊口→生活
何堪→那堪
莫非→难道
扭捏→摇摆
翦灭→扫除
技击→武术
街市→市井
呵护→庇护
好笑→可笑
前提→条件
眸子→眼珠
辉映→照映
甲由→蟑螂
烧饭→煮饭
豪举→壮举
呼叫→呼唤
花腔→花样
怀怨→抱恨
华山→西岳
命脉→命根子
会萃→聚集
甲鱼→团鱼
爬泳→自由式泳法
缺漏→罅漏
房主→房东
横目→怒目
洽谈→洽商
暮秋→深秋
耳目→线人
发源→起源
专制→独裁
片子→电影
自夸→自诩
风貌→风采
肥饶→肥沃
茂发→向荣
贮备→储备
轻风→微风
黑点→斑点
酣畅→畅快
摄生→养生
餬口→谋生
高寿→遐龄
轨制→制度
捍卫→保卫
冗赋→杂税
甘旨→美味
工业→产业
坟墓→宅兆
犯禁→违禁
专横→跋扈
豆芽→芽菜
署理→代理
神姿→丰采
讹传→谣传
功课→作业
割断→切断
跟着→随着
够数→足数
鹄候→伫候
逛逛→走走
泛起→出现
斗胆→大胆
卓见→卓识
恶疾→顽疾
绳尺→准绳
动弹→转动
互市→通商
拂拭→扫除
给以→赐与
喜剧→笑剧
赅博→渊博
更甚→愈甚
顾恤→怜惜
光鲜→鲜明
涵养→修养
谋事→找事
模样→样子容貌
惹人→引人
活捉→生擒
火炬→火把
商定→约定
施展→发挥
共识→共鸣
寄迹→托足
讳饰→遮掩
贵姓→尊姓
润饰→修饰
毫不→绝不
狐臭→腋臭
巧合→偶合
热点→热门
回心→转意
轻柔→柔柔
贵体→玉体
人员→职员
孤傲→孤独
规画→筹划
鹄立→伫立
呼叱→叱责
何为→作甚
泥土→土壤
焚杀→屠烧
转晴→放晴
干犯→冒犯
扶病→抱病
改嫁→再醮
归→回
铺→展
去→往
望→看
绝→尽
藏→躲
遥→远
入→进
鸣→叫
暖→热
舟→船
寒→冷
瞅→看
Nine commentaries→***
self-immolation→***
chinesenewsnet→***
TNT,C4等炸弹制作方法→***
jiangdongriji→***
zhengjianwang→***
chinaliberal→***
minghuinews→***
根敦·确吉、确吉尼玛 →***
原子弹的理论 恐怖分子→***
制作炸弹首先要制作炸药→***
恐怖分子 第一步 炸弹→***
triangleboy→***
恐怖分子DIY 原子弹→***
oppression →***
zhenshanren→***
c4 炸弹 制作方法→***
在家里做原子弹的方法→***
zhuanfalun→***
手把手 制作原子弹 →***
renmingbao→***
简易制作C4炸弹教程→***
出售雷管炸药自制炸弹→***
Li Hongzhi→***
Falun Dafa→***
出售四六级英语答案→***
hypermart→***
售麻醉 联系电话 →***
TNT炸弹制作方法→***
tnt炸药 制作 →***
UltraSurf→***
zhengjian→***
C4塑胶炸药制作 →***
zhuanfalu→***
手把手教你做原子弹→***
原子弹的简易制法 →***
freechina→***
TNT炸药制作方法→***
lihongzhi→***
原子弹的DIY制作→***
falundafa→***
renminbao→***
手把手教你作原子弹→***
peacehall→***
tianwang→***
一盒一次针剂麻醉→***
如何做炸药 炸弹→***
恐怖分子傻瓜手册→***
hrichina→***
creaders→***
tibetalk→***
恐怖分子皮箱炸弹→***
工业炸药配方设计→***
dajiyuan→***
triangle→***
销售 军用手枪 →***
台湾青年独立联盟→***
交大高考招生黑幕→***
台湾建国运动组织→***
原子弹制作方法 →***
xinsheng→***
身份证号码生成器→***
minghui→***
隐形手机窃听器→***
做原子弹 方法→***
简易原子弹制作→***
中国国家防火墙→***
轻松制作原子弹→***
根敦·确吉尼玛→***
freenet→***
台湾团结联盟 →***
playboy→***
hongzhi→***
DIY原子弹 →***
safeweb→***
unixbox→***
北大三角地论坛→***
鲜为人知的故事→***
heroine→***
chinamz→***
1989天安门→***
ustibet→***
wstaiji→***
土制C4 过程→***
出售全自动步枪→***
港产二类GHB→***
如何制作原子弹→***
出售雷管 炸药→***
bignews→***
绿色手机窃听器→***
北美自由论坛→***
hentai→***
wangce→***
两岸三地论坛→***
C4炸药制作→***
cocain→***
央视内部晚会→***
censor→***
恐怖分子必备→***
瑞士金融大学→***
人民之声论坛→***
yuming→***
incest→***
炸药制作方法→***
making→***
1Pondo→***
人民内情真相→***
制作原子弹 →***
世界经济导报→***
身份证生成器→***
高校群体事件→***
子女任职名单→***
simple→***
一般炸药制作→***
香港GHB水→***
东土耳其斯坦→***
西藏流亡政府→***
huanet→***
新唐人电视台→***
颠覆国家政权→***
活体器官移植→***
东西南北论坛→***
南大自由论坛→***
你说我说论坛→***
华岳时事论坛→***
东南西北论谈→***
台湾自由联盟→***
地下的先烈们→***
喷雾型迷魂药→***
华语世界论坛→***
简易炸药制作→***
春夏自由论坛→***
风雨神州论坛→***
小泽玛莉亚 →***
自由亚洲电台→***
枪 货到付款→***
大众真人真事→***
华通时事论坛→***
大纪元新闻网→***
皮箱炸弹构造→***
佛展千手法→***
神通加持法→***
短信群发器→***
中华民国 →***
口服型迷药→***
boxun→***
新华通论坛→***
出售枪支 →***
炸弹怎么做→***
falun→***
川岛和津实→***
炸药配方 →***
热站政论网→***
群体灭绝 →***
性免费电影→***
甲基苯丙胺→***
上海工字牌→***
正义党论坛→***
廉政大论坛→***
黑瞎子岛 →***
贯通两极法→***
唐人电视台→***
台湾最新版→***
台湾政论区→***
大中国论坛→***
香烟型迷药→***
paper→***
独立台湾会→***
手机窃听器→***
天安门事件→***
上海孤儿院→***
毛泽东复活→***
劳动教养所→***
鸡毛信文汇→***
针孔摄像头→***
文化大革命→***
黄色小电影→***
拍肩神药v→***
无界浏览器→***
《新京报》→***
bitch→***
九评共产党→***
半自动猎枪→***
大中华论坛→***
anime→***
自制原子弹→***
佳静安定片→***
色情小电影→***
出售麻醉枪→***
激情小电影→***
地下先烈们→***
信息产业部→***
持不同政见→***
江core→***
东方红时空→***
升达毕业证→***
新观察论坛→***
反封锁技术→***
naive→***
夜话紫禁城→***
微型窃听器→***
出售炸药 →***
巴拉贝鲁姆→***
PK黑社会→***
强效失忆药→***
反腐败论坛→***
出售弹药 →***
成人影视→***
出售假币→***
出售假钞→***
黄色网站→***
黄色图片→***
黄色漫画→***
黄色电影→***
飞扬论坛→***
东北独立→***
东方时空→***
电视流氓→***
地下刊物→***
董必武 →***
地下教会→***
激流中国→***
代开发票→***
草莓牛奶→***
粉饰太平→***
风雨神州→***
大 纪元→***
出售麻古→***
歌功颂德→***
华夏文摘→***
出售猎枪→***
迪里夏提→***
成人图片→***
黄色小说→***
黄色影视→***
回民暴动→***
捷克手枪→***
成人小说→***
华国锋 →***
激情电影→***
个人崇拜→***
成人网站→***
活人器官→***
成人论坛→***
大家论坛→***
蒋方良 →***
蒋介石 →***
蒋经国 →***
陈独秀 →***
黄色文学→***
及川奈央→***
达赖喇嘛→***
制作工艺→***
杨尚昆 →***
三浦爱佳→***
异议人士→***
四川独立→***
孙中山 →***
新疆独立→***
轻舟快讯→***
汕尾东洲→***
时代论坛→***
色情网站→***
夕树舞子→***
执法犯法→***
迷魂药 →***
善恶有报→***
台湾独立→***
全国两会→***
争鸣论坛→***
向忠发 →***
自由亚州→***
西藏独立→***
周恩来 →***
信用危机→***
异见人士→***
少儿不宜→***
双桶猎枪→***
新华举报→***
新华内情→***
透视眼镜→***
约会春药→***
土匪政府→***
舆论反制→***
十一连发→***
新闻封锁→***
成人文学→***
统独论坛→***
事实独立→***
人民真实→***
星崎未来→***
医用乙醚→***
一中一台→***
一码中特→***
夜勤病栋→***
雪山狮子→***
鹰牌猎枪→***
麻醉乙醚→***
侦探设备→***
强硬发言→***
投毒杀人→***
枪决女犯→***
恶搞晚会→***
军长发威→***
西藏天葬→***
对日强硬→***
军用手枪→***
帝国之梦→***
手机复制→***
买卖枪支→***
六四事件→***
瞿秋白 →***
falu→***
金泽文子→***
北京当局→***
dfdz→***
fuck→***
nacb→***
色情服务→***
高校暴乱→***
蒙古独立→***
国家安全→***
血腥图片→***
枪支弹药→***
高干子女→***
高干子弟→***
办理文凭→***
枪决现场→***
拍肩神药→***
迷醉钢枪→***
大学骚乱→***
官商勾结→***
盘古乐队→***
天鹅之旅→***
自制手枪→***
远程偷拍→***
古方迷香→***
蒙汗药粉→***
自杀手册→***
自杀指南→***
窃听器材→***
高校骚乱→***
成人电影→***
美国参考→***
毛泽东 →***
成人漫画→***
麻醉手枪→***
北京之春→***
六四天网→***
流氓警察→***
猎枪销售→***
两个中国→***
美国之音→***
高薪养廉→***
胡总书记→***
花花公子→***
虎头猎枪→***
胡耀邦 →***
国民党 →***
nmis→***
办理证件→***
国家信息→***
国家机密→***
出售手枪→***
迷药销售→***
强盗警察→***
开放杂志→***
svdc→***
红色恐怖→***
cdjp→***
(av)→***
迷幻香烟→***
taip→***
(hz)→***
shit→***
(sm)→***
彭德怀 →***
民族矛盾→***
泡沫经济→***
dafa→***
民意论坛→***
木子论坛→***
[sm]→***
[hz]→***
[av]→***
两岸关系→***
54式→***
flg→***
白皮书→***
淫水 →***
易志熹→***
转法轮→***
易丹轩→***
voa→***
xxx→***
朱鎔基→***
白立朴→***
白秀华→***
摇头丸→***
rfa→***
张万年→***
18禁→***
一本道→***
尹庆民→***
郭起真→***
郭罗基→***
郭岩华→***
推油 →***
专制 →***
64式→***
酣乐欣→***
韩东方→***
张宏堡→***
工自联→***
sex→***
大史纪→***
张伟国→***
gcd→***
张丕林→***
张伯笠→***
昝爱宗→***
在十月→***
宇明网→***
张昭富→***
韩联潮→***
王涵万→***
谢中之→***
谢选骏→***
谢长廷→***
催情药→***
大参考→***
大盖帽→***
大鸡巴→***
赵海青→***
姚月谦→***
大史记→***
信产局→***
检察院→***
大泽惠→***
郭伯雄→***
独裁 →***
小参考→***
小电影→***
大纪元→***
郑贻春→***
77式→***
85式→***
88式→***
92式→***
95式→***
张五常→***
A片 →***
辛灏年→***
朱德 →***
新生网→***
正见网→***
cnd→***
真善忍→***
赵紫阳→***
dpp→***
赵品潞→***
张志清→***
74式→***
避孕套→***
王若望→***
杜导斌→***
杜智富→***
发正念→***
尉健行→***
反共 →***
魏新生→***
文字狱→***
武腾兰→***
顶级 →***
王沪宁→***
温家宝→***
泛蓝 →***
泛绿 →***
饭岛爱→***
方励之→***
温元凯→***
反人类→***
反社会→***
钓鱼岛→***
消防队→***
学自联→***
封从德→***
丁关根→***
冯素英→***
方舟子→***
冯东海→***
慰安妇→***
斐得勒→***
魏京生→***
费良勇→***
分家在→***
王希哲→***
王小宁→***
丁子霖→***
王秀丽→***
封锁 →***
洪哲胜→***
王冶坪→***
王瑞林→***
台湾狗→***
贾育台→***
唐柏桥→***
乖乖粉→***
傅申奇→***
傅怡彬→***
傅志寰→***
贾庆林→***
高文谦→***
苏家屯→***
高自联→***
王力雄→***
绝版 →***
大纪园→***
红灯区→***
共铲党→***
付申奇→***
关卓中→***
王润生→***
黑社会→***
王辅臣→***
胡紧掏→***
胡锦涛→***
胡锦滔→***
胡锦淘→***
胡景涛→***
华建敏→***
贾廷安→***
黄慈萍→***
王军涛→***
汤光中→***
何德普→***
台湾版→***
悔过书→***
苏晓康→***
姬胜德→***
积克馆→***
苏绍智→***
天安门→***
江泽民→***
邵家健→***
罗永忠→***
江猪媳→***
綦彦臣→***
罗礼诗→***
江折民→***
江戏子→***
卖国 →***
迷幻药→***
江主席→***
江则民→***
钱国梁→***
抢粮记→***
江绵恒→***
窃听器→***
江贼民→***
上海帮→***
林慎立→***
盛华仁→***
教养院→***
连胜德→***
任自元→***
梁光烈→***
蒲团 →***
梁擎墩→***
罗长福→***
廖锡龙→***
林保华→***
林彪 →***
林长盛→***
民主墙→***
猛插 →***
蒙汗药→***
反政府→***
法轮功→***
麻醉药→***
毛－鲜→***
黎阳评→***
监听王→***
戴海静→***
江流氓→***
迷奸药→***
姜春云→***
成人片→***
共产党→***
管理员→***
杨怀安→***
项小吉→***
春宫图→***
张小平→***
三唑仑→***
建国党→***
钦本立→***
钱其琛→***
潘国平→***
江泽慧→***
麻醉枪→***
吕京花→***
陆委会→***
欧阳懿→***
将则民→***
吕秀莲→***
马大维→***
氯胺酮→***
龙虎豹→***
乱交 →***
江八点→***
僵贼民→***
程铁军→***
明思网→***
小泽园→***
新语丝→***
陈宣良→***
陈一谘→***
陈总统→***
杨建利→***
性虐待→***
李洪志→***
迟浩田→***
杨月清→***
陈破空→***
揭批书→***
女优 →***
明慧网→***
成人区→***
长濑爱→***
陈希同→***
第四代→***
蔡崇国→***
蔡陆军→***
曹长青→***
项怀诚→***
新唐人→***
插插 →***
陈小同→***
朝河兰→***
邓笑贫→***
陈炳基→***
邓小平→***
戴相龙→***
司法部→***
曹刚川→***
兽交 →***
六合采→***
酱猪媳→***
李洪宽→***
劳教 →***
黎安友→***
李大师→***
李登辉→***
双十节→***
民进党→***
迷奸水→***
明心网→***
陈秋兰→***
倪育贤→***
女女 →***
你妈逼→***
六合彩→***
蒋世华→***
李红痔→***
林樵清→***
莫伟强→***
三级 →***
迷幻液→***
金尧如→***
三级片→***
毛贼东→***
木犀地→***
热比娅→***
李宏志→***
留园网→***
人权 →***
看中国→***
邝锦文→***
毛厕洞→***
溜麻古→***
脱衣→***
男妓→***
露胸→***
共军→***
走光→***
阴部→***
乳房→***
亮剑→***
授交→***
和谐→***
妓女→***
王刚→***
哥疼→***
锦涛→***
交警→***
多党→***
国贼→***
偷情→***
国军→***
叫床→***
接班→***
郭平→***
共匪→***
姐痛→***
鸡吧→***
广闻→***
轮攻→***
近亲→***
共狗→***
发春→***
嫩穴→***
嫩B→***
大炮→***
淫乱→***
吞精→***
姐疼→***
干你→***
屙民→***
联总→***
独夫→***
炼功→***
动乱→***
东洲→***
东社→***
多维→***
口交→***
俄国→***
干她→***
抗议→***
空难→***
盛雪→***
腐败→***
升天→***
肛门→***
捅我→***
发愣→***
法论→***
禁书→***
春药→***
反华→***
昏药→***
鬼村→***
退党→***
淫糜→***
连发→***
网特→***
特码→***
法轮→***
法沦→***
法伦→***
发论→***
发轮→***
发沦→***
发伦→***
反攻→***
李鹏→***
何山→***
洪吟→***
护法→***
统战→***
捅你→***
母子→***
胡平→***
沈彤→***
疆独→***
僵贼→***
洪智→***
色狼→***
水扁→***
童屹→***
洪传→***
宏法→***
红智→***
红志→***
偷窥→***
爽死→***
偷拍→***
讲法→***
私处→***
达赖→***
菱恝→***
干他→***
林海→***
师父→***
西藏→***
凌锋→***
弟子→***
弟痛→***
吸储→***
凌辱→***
露点→***
下体→***
色友→***
底裤→***
流亡→***
登辉→***
荡妇→***
弹劾→***
六四→***
洪志→***
弟疼→***
经文→***
河殇→***
睾丸→***
何勇→***
秦晋→***
精液→***
警察→***
九评→***
蛤蟆→***
石戈→***
交班→***
哥痛→***
天葬→***
戈扬→***
公款→***
师涛→***
高瞻→***
卡通→***
开苞→***
高官→***
高干→***
高潮→***
鸽派→***
护士→***
小穴→***
台盟→***
假币→***
丝袜→***
斯诺→***
极景→***
税力→***
激情→***
基督→***
鸡巴→***
江青→***
肛交→***
台独→***
统独→***
黄翔→***
江贼→***
唐捷→***
唐子→***
江猪→***
换妻→***
天怒→***
江罗→***
真相→***
张健→***
张林→***
内射→***
庆红→***
群射→***
则民→***
赵南→***
虐杀→***
赵岩→***
罗干→***
群交→***
贼民→***
真象→***
喷精→***
闹事→***
妹疼→***
冰毒→***
波霸→***
博讯→***
潮吹→***
迫害→***
哲民→***
自摸→***
援交→***
专政→***
祁建→***
A级→***
喷尿→***
钱达→***
镇压→***
强歼→***
窃听→***
内裤→***
亲美→***
张钢→***
自拍→***
自慰→***
作爱→***
做爱→***
齐墨→***
虐待→***
民警→***
泽民→***
K粉→***
程真→***
自焚→***
杨巍→***
性爱→***
臭作→***
暴乱→***
暴政→***
薄格→***
暴动→***
婊子→***
鲍彤→***
赤化→***
麻果→***
赤匪→***
陈军→***
被逼→***
猫肉→***
论攻→***
被虐→***
被迫→***
肉棍→***
论功→***
变态→***
轮功→***
北韩→***
插她→***
肉欲→***
阳具→***
藏独→***
蒙独→***
三唑→***
陈蒙→***
性交→***
妹痛→***
麻衣→***
暴干→***
程凯→***
杨周→***
插你→***
城管→***
插他→***
插我→***
学潮→***
柴玲→***
麻古→***
常劲→***
妈个→***
屁眼→***
颜射→***
轮公→***
阴户→***
抡功→***
露毛→***
吹萧→***
伦功→***
伦攻→***
沦公→***
沦功→***
邪恶→***
轮大→***
打倒→***
共党→***
禁看→***
共产→***
功法→***
龟头→***
破处→***
鲍戈→***
射精→***
阴蒂→***
沦攻→***
文革→***
老江→***
口技→***
老毛→***
风花→***
狂干→***
分裂→***
捆绑→***
少妇→***
大史→***
劳改→***
阴道→***
封杀→***
伦公→***
丁元→***
大麻→***
更衣→***
大法→***
乱伦→***
肖强→***
打炮→***
调教→***
论公→***
樱井→***
白梦→***
迷药→***
肉棒→***
巴赫→***
八老→***
八九→***
阴唇→***
一党→***
择民→***
迷奸→***
伊东→***
肉洞→***
义解→***
大片→***
亦凡→***
民联→***
民意→***
密穴→***
情妇→***
造爱→***
情色→***
郑义→***
民国→***
阴门→***
明慧→***
游行→***
幼齿→***
应招→***
民阵→***
阴茎→***
民运→***
阴囊→***
幼交→***
阴毛→***
诱惑→***
舆论→***
岳武→***
民主→***
绵恒→***
保钓→***
民猪→***
奸→***
裸→***
穴→***
嫖→***
淫→***
纯真→纯挚
戳穿→揭穿
揭穿→戳穿
慈爱→慈祥
次序→顺序
顺序→次序
聪慧→聪明
聪明→聪慧
聪颖→伶俐
伶俐→聪颖
葱茏→葱郁
葱郁→葱茏
匆忙→匆仓促
匆促→仓促
匆匆→促
仓促→匆促
凑集→聚集
聚集→凑集
粗暴→粗鲁
粗鲁→粗暴
粗俗→粗鄙
粗鄙→粗俗
簇拥→蜂拥
蜂拥→簇拥
篡夺→夺取
夺取→篡夺
篡改→改动
窜改→篡改
改动→修改
脆弱→懦弱
懦弱→脆弱
村庄→村落
村落→村
村子→村庄
存放→寄存
寄存→存放
寄放→存放
措施→办法
办法→措施
错误→过错
过错→错误
差错→错误
搭档→错误
同伴→错误
达到→到达
到达→达到
答复→回答
回答→答复
回覆→答复
打扮→装扮
装扮→打扮
打量→端详
端详→打量
打扫→扫除
扫除→打扫
打算→盘算
盘算→打算
计划→打算
企图→打算
打消→消除
消除→打消
大批→大量
大量→大批
大宗→大批
大师→巨匠
大众→民众
民众→大众
公众→大众,
呆板→死板
死板→呆板
古板→呆板
呆滞→凝滞
歹徒→暴徒
暴徒→歹徒
逮捕→拘捕
拘捕→逮捕
代替→取代
取代→代替
带领→率领
率领→带领
怠惰→懒惰
懒惰→怠惰
单薄→薄弱
薄弱→单薄
担负→担当
担当→担负
担任→担负
担心→担忧
担忧→担心
耽误→延误
延误→耽搁
耽搁→耽误
胆怯→恐惧
恐惧→胆怯
畏怯→胆怯
淡薄→淡漠
淡漠→淡薄
诞辰→生日
生日→诞辰
寿辰→诞辰
捣乱→捣蛋
捣蛋→捣鬼
捣鬼→捣乱
悼念→吊唁
吊唁→悼念
怀念→悼念
道路→途径
途径→道路
道贺→道喜
道喜→道贺
贺喜→道贺
道歉→报歉
等候→等待
等待→等候
低沉→消沉
消沉→低沉
敌视→仇视
仇视→敌视
底本→原本
原本→底本
蓝本→底本
底细→内情
内情→底细
抵挡→招架
招架→抵挡
抵触→抵牾
抵牾→抵触
矛盾→抵触
抵抗→抵御
抵御→抵抗
诋毁→毁谤
毁谤→诋毁
地步→田地
田地→地步
境地→地步
地区→地域
地域→地区
地位→位置
位置→地位
颠覆→推翻
推翻→颠覆
典范→典型
典型→典范
点缀→装点
装点→点缀
玷污→玷辱
玷辱→玷污
惦记→惦念
惦念→惦记
凋零→凋落
凋落→凋零
凋谢→凋零
调换→更换
更换→调换
替换→调换
掉队→落伍
落伍→掉队
钓饵→诱饵
诱饵→钓饵
懂得→理解
理解→懂得
了解→懂得
领会→懂得
动摇→摇动
摇动→动摇
动人→动听
动听→动人
恫吓→恐吓
恐吓→恫吓
吓唬→恫吓
陡峭→峻峭
峻峭→陡峭
毒辣→狠毒
狠毒→毒辣
独裁→专制
独断→专断
专断→独断
赌气→负气
负气→赌气
生气→赌气
度过→渡过
断定→判断
判断→断定
确定→断定
断送→葬送
对抗→抗衡
抗衡→对抗
对照→对比
对比→对照
对峙→对立
对立→对峙
堕落→腐化
腐化→堕落
蜕化→堕落
讹诈→敲诈
敲诈→讹诈
欺诈→讹诈
恶毒→狠毒
狠毒→恶毒
恩惠→恩情
恩情→恩惠
恩典→恩惠
发布→宣布
宣布→发布
发动→动员
动员→发动
发抖→颤抖
颤抖→发抖
哆嗦→发抖
发掘→挖掘
挖掘→发掘
发明→发现
发现→发明
会见→会面
会面→会见
会晤→会见
会合→汇合
汇合→会合
会心→会意
会意→会心
昏暗→阴暗
阴暗→昏暗
浑厚→浑朴
浑厚→憨厚
憨厚→浑厚
憨实→憨厚
淳厚→浑厚
淳朴→浑厚
混乱→凌乱
凌乱→混乱
紊乱→杂乱
杂乱→混乱
混杂→混淆
混淆→混杂
混合→混杂
活力→活气
活气→活力
生机→活力
生气→活力
活泼→活跃
活跃→活泼
火把→火炬
豁达→开朗
开朗→豁达
基础→基本
基本→基础
根基→基础
激动→冲动
冲动→激动
感动→激动
激烈→剧烈
剧烈→激烈
猛烈→激烈
饥荒→饥馑
机动→灵活
灵活→机动
机会→机遇
机遇→机会
时机→机会
机灵→机警
机警→机灵
机智→机灵
机密→秘密
秘密→机密
积累→积聚
积聚→积累
积存→积压
缉获→缴获
汲取→吸取
吸取→汲取
集合→聚集
聚集→集合
聚拢→集合
急切→迫切
迫切→急切
急迫→急切
急忙→匆忙
匆忙→急忙
慌忙→急忙
棘手→辣手
辣手→棘手
计划→规划
规划→计划
技巧→技能
技能→技巧
技术→技巧
伎俩→手法
手法→伎俩
记录→记载
发誓→起誓
起誓→发誓
赌咒→发誓
烦恼→懊恼
懊恼→烦恼
烦躁→焦躁
焦躁→烦躁
繁忙→忙碌
忙碌→繁忙
繁荣→繁华
繁华→繁荣
繁殖→滋生
滋生→繁殖
孳生→繁殖
反抗→对抗
对抗→反抗
反叛→反水
反水→反叛
叛变→反叛
反应→反映
反映→反应
反响→反应
反应→反响
范畴→范围
范围→范畴
犯法→犯罪
犯罪→犯法
方案→计划
计划→方案
方便→便利
便利→方便
范例→典范
典范→范例
方法→方式
方式→方法
方法→办法
办法→方法
法子→方法
芳香→芬芳
防备→防范
防范→防备
提防→防备
妨碍→妨害
妨害→妨碍
阴碍→妨碍
访问→拜访
拜访→访问
造访→访问
走访→访问
仿造→仿制
仿制→仿造
放荡→放纵
放纵→放荡
放纵→放肆
放肆→放纵
放弃→废弃
废弃→放弃
飞奔→飞驰
翱翔→飞翔
飞行→飞翔
飞翔→飞行
菲薄→微薄
微薄→菲薄
诽谤→毁谤
毁谤→诽谤
诬蔑→诽谤
废除→废止
废止→废除
费心→费神
费神→费心
劳神→费心
分辩→辩白
辩白→分辩
分说→分辩
分辨→辨别
辨别→分辨
分别→分辨
分辨→分辩
分辩→分辨
分别→分离
分离→分别
分手→分别
分析→剖析
剖析→分析
纷纷→纷纭
纷纭→纷纷
纷繁→纷纷
纷乱→缭乱
缭乱→纷乱
凌乱→纷乱
吩咐→嘱咐
嘱咐→吩咐
叮嘱→吩咐
粉饰→掩饰
掩饰→粉饰
奋斗→斗争
斗争→奋斗
奋发→发奋
发奋→奋发
发愤→奋发
丰富→丰盛
丰盛→丰富
丰厚→丰富
丰富→丰硕
丰收→丰产
丰产→丰收
丰登→丰收
风采→风度
风度→风采
风度→风姿
风姿→风度
风韵→风度
风景→景致
景致→风景
景色→风景
风气→风尚
风尚→风气
风俗→风气
风趣→幽默
幽默→风趣
风行→盛行
盛行→风行
流行→风行
锋利→锐利
锐利→锋利
犀利→锋利
讽刺→讥讽
讥讽→讽刺
讥诮→讽刺
挖苦→讽刺
奉承→阿谀
阿谀→奉承
恭维→奉承
否定→否认
否认→否定
敷衍→应付
应付→敷衍
肤浅→浮浅
浮浅→肤浅
浅薄→肤浅
浮现→显现
显现→浮现
呈现→浮现
浮躁→急躁
急躁→浮躁
服从→遵从
遵从→服从
顺从→服从
抚养→抚育
抚育→抚养
扶植→培植
培植→扶植
腐败→腐朽
腐朽→腐败
腐烂→糜烂
糜烂→腐烂
腐败→腐烂
腐化→腐蚀
腐蚀→腐化
附近→邻近
邻近→附近
左近→附近
附属→从属
从属→附属
隶属→附属
富饶→富裕
富裕→富饶
富强→强盛
强盛→富强
负伤→挂花
挂花→负伤
挂彩→负伤
温习→复习
复杂→庞杂
庞杂→复杂
繁杂→复杂
改革→改造
改造→改革
革新→改革
改良→改进
改进→改良
改善→改良
改正→矫正
矫正→改正
干净→清洁
清洁→干净
洁净→干净
干枯→干涸
干涸→干枯
干涉→干预
干预→干涉
甘心→情愿
情愿→甘心
感到→觉得
觉得→感到
感觉→感到
感谢→感激
感激→感谢
感想→感触
感触→感想
感叹→感慨
感慨→感叹
刚强→坚强
坚强→刚强
纲领→纲要
纲要→纲领
高超→高明
高明→高超
高昂→昂扬
昂扬→高昂
高低→高下
高下→高低
上下→高低
高雅→文雅
文雅→高雅
高级→高等
高等→高级
高档→高级
高尚→高贵
高贵→高尚
高深→精深
精深→高深
精湛→高深
高兴→愉快
愉快→高兴
兴奋→高兴
告诉→告知
告知→告诉
奉告→告诉
歌颂→歌唱
歌唱→歌颂
讴歌→歌颂
隔绝→隔断
隔断→隔绝
格式→格局
款式→格式
根本→基本
基本→根本
根据→依据
依据→根据
更换→改换
改换→更换
工夫→功夫
功夫→工夫
公平→公正
公正→公平
公道→公平
功效→功能
功能→功效
功劳→功绩
功绩→功劳
功勋→功劳
恭敬→恭顺
供给→供应
提供→供给
供养→赡养
赡养→供养
共鸣→共识
勾画→勾勒
勾结→勾搭
勾搭→勾结
勾引→引诱
引诱→勾引
购置→购买
购买→购置
估计→估量
估量→估计
孤单→孤独
孤独→孤单
鼓励→激励
激励→鼓励
鼓动→煽动
煽动→鼓动
怂恿→鼓动
古怪→怪僻
怪僻→古怪
故居→旧居
旧居→故居
故乡→家乡
家乡→故乡
顾问→参谋
固执→执拗
执拗→固执
顽固→固执
挂念→牵挂
牵挂→挂念
观察→察看
察看→观察
观赏→欣赏
欣赏→观赏
关心→关怀
关怀→关心
关切→关心
贯串→贯穿
惯例→通例
通例→惯例
常规→惯例
惯用→习用
习用→惯用
光明→光亮
光亮→光明
光荣→光彩
光彩→光荣
荣耀→光荣
光辉→辉煌
辉煌→光辉
广博→渊博
渊博→广博
广阔→辽阔
辽阔→广阔
宽阔→广阔
广泛→普遍
普遍→广泛
规矩→规则
规则→规矩
规模→范围
范围→规模
归罪→归咎
归咎→归罪
狡辩→诡辩
诡计→阴谋
阴谋→诡计
国土→领土
领土→国土
国事→国是
国家→国度
国度→国家
国民→公民
公民→国民
人民→国民
果断→武断
武断→果断
过细→细致
细致→过细
过程→进程
进程→过程
历程→过程
过火→过分
过分→过火
过头→过火
过甚→过火
过剩→多余
多余→过剩
害怕→惧怕
惧怕→害怕
恐惧→害怕
含混→含糊
含糊→含混
模糊→含混
豪放→豪迈
豪迈→豪放
豪爽→豪放
豪华→奢华
奢华→豪华
豪情→激情
激情→豪情
好汉→英雄
英雄→好汉
耗费→消耗
消耗→耗费
耗损→耗费
号召→号令
号令→号召
召唤→号召
和睦→和气
和气→和睦
和气→和蔼
和蔼→和气
和善→和气
和谐→协调
协调→和谐
合适→适合
适合→合适
适宜→合适
合格→及格
及格→合格
黑沉沉→黑洞洞
黑洞洞→黑沉沉
黑魆魆→黑沉沉
黑糊糊→黑沉沉
黑黝黝→黑沉沉
衡量→权衡
权衡→衡量
烘托→衬托
衬托→烘托
宏伟→雄伟
宏大→巨大
巨大→宏大
庞大→宏大
忽略→疏忽
摆脱→解脱
解脱→摆脱
拜见→拜会
拜会→拜见
拜望→拜见
拜谒→拜见
颁布→公布
公布→颁布
伴随→随同
随同→伴随
伴同→伴随
帮助→辅助
辅助→帮助
帮凶→爪牙
爪牙→帮凶
走狗→帮凶
榜样→模范
模范→榜样
楷模→榜样
表率→榜样
傍晚→薄暮
薄暮→傍晚
黄昏→傍晚
褒奖→嘉奖
嘉奖→褒奖
夸奖→褒奖
包含→包括
包括→包含
包孕→包含
包围→包抄
保持→坚持
坚持→保持
维持→保持
保存→保留
保护→维护
维护→保护
保卫→捍卫
保养→颐养
颐养→保养
保重→珍重
珍重→保重
饱满→丰满
抱歉→负疚
抱怨→埋怨
悲哀→悲痛
悲痛→悲哀
悲恸→悲哀
悲凉→凄凉
凄凉→悲凉
凄切→悲凉
凄惨→悲凉
卑鄙→卑劣
卑劣→卑鄙
卑贱→卑下
卑下→卑贱
低贱→卑贱
卑微→低微
低微→卑微
微贱→卑微
奔跑→奔驰
奔驰→奔跑
奔腾→奔跑
奔走→奔忙
奔忙→奔走
奔波→奔走
本来→原来
原来→本来
原本→本来
原先→本来
本事→本领
本领→本事
本质→实质
实质→本质
本色→本质
爱护→爱惜
爱惜→爱护
珍惜→爱护
爱慕→倾慕
倾慕→爱慕
羡慕→爱慕
爱好→喜好
喜好→爱好
喜欢→爱好
喜爱→爱好
嗜好→爱好
暧昧→暗昧
暗昧→暧昧
含糊→暧昧
安定→安宁
安宁→安定
安静→宁静
宁静→安静
恬静→安静
平静→安静
清静→安静
寂静→安静
幽静→安静
安排→部署
部署→安排
布置→安排
安排→支配
支配→安排
安适→安逸
安逸→安适
安闲→安适
安慰→抚慰
抚慰→安慰
劝慰→安慰
安稳→平稳
平稳→安稳
安息→安眠
安眠→安息
安闲→清闲
清闲→安闲
悠闲→安闲
安置→安顿
安放→安置
暗害→暗杀
暗杀→暗害
暗算→暗害
暗藏→隐藏
隐藏→暗藏
潜藏→暗藏
阴影→暗影
按照→依照
依照→按照
遵照→按照
肮脏→龌龊
龌龊→肮脏
恶浊→肮脏
鏖战→激战
激战→鏖战
懊悔→后悔
后悔→懊悔
忏悔→懊悔
把守→扼守
扼守→把守
把持→操纵
操纵→把持
控制→把持
白费→空费
空费→白费
枉费→白费
白净→白皙
摆设→陈设
陈设→摆设
陈列→摆设
本相→原形
原形→本相
真相→本相
本性→天性
天性→本性
笨拙→愚笨
愚笨→笨拙
愚蠢→笨拙
崩溃→瓦解
瓦解→崩溃
逼迫→强迫
强迫→逼迫
逼真→真切
真切→逼真
比较→比拟
比拟→比较
对比→比较
比赛→竞赛
竞赛→比赛
比喻→比方
比方→比喻
笔挺→笔直
鄙弃→唾弃
唾弃→鄙弃
蔑视→鄙弃
藐视→鄙弃
轻视→鄙弃
弊病→弊端
弊端→弊病
毛病→弊病
必定→一定
一定→必定
必然→必定
必须→必需
究竟→毕竟
终究→毕竟
毕生→终生
终生→毕生
终身→毕生
鞭笞→鞭挞
鞭挞→鞭笞
编辑→编纂
边境→边疆
边疆→边境
边陲→边境
边沿→边缘
辨别→鉴别
鉴别→辨别
辨认→识别
识别→辨认
辩护→辩解
辩解→辩护
辩白→辩护
变更→变革
变革→变更
变化→变更
变节→叛变
叛变→变节
标记→标志
标志→标记
标题→题目
题目→标题
标准→尺度
表现→表示
表示→表现
表扬→表彰
表彰→表扬
别名→别号
冰冷→冰凉
兵器→武器
武器→兵器
禀赋→天赋
天赋→禀赋
波涛→波澜
波折→曲折
曲折→波折
博得→赢得
赢得→博得
搏斗→格斗
格斗→搏斗
肉搏→搏斗
哺养→哺育
哺育→哺养
补充→弥补
弥补→补充
补贴→补助
补助→补贴
部队→军队
军队→部队
猜忌→猜疑
猜疑→猜忌
怀疑→猜忌
才干→才华
才华→才干
才气→才干
才能→才干
材料→资料
资料→材料
采用→采取
采取→采用
采纳→采用
参军→从军
从军→参军
入伍→参军
参加→加入
加入→参加
残暴→残酷
残酷→残暴
残忍→残暴
灿烂→残暴
绚烂→残暴
璀璨→残暴
苍茫→苍莽
仓促→仓皇
仓皇→仓促
操心→费心
费心→操心
品行→操行
草率→轻率
轻率→草率
策划→谋划
谋划→策划
筹划→谋划
测验→考试
考试→测验
差别→差异
差异→差别
区别→差别
查访→察访
察访→查访
刹那→霎时
霎时→刹那
顷刻→刹那
搀和→搀杂
搀杂→搀和
产生→发生
发生→产生
铲除→革除
革除→铲除
根除→铲除
阐明→说明
说明→阐明
谄谀→谄媚
谄媚→谄谀
讨好→谄谀
猖狂→猖獗
猖獗→猖狂
疯狂→猖狂
长久→久长
久长→长久
悠久→长久
长年→终年
终年→长年
场合→场所
场所→场合
怅惘→惘然
惘然→怅惘
抄写→缮写
缮写→抄写
抄录→抄写
抄袭→剽窃
剽窃→抄袭
超出→超越
超越→超出
越过→超出
嘲笑→讥笑
讥笑→嘲笑
耻笑→嘲笑
撤退→退却
退却→撤退
沉静→沉寂
沉寂→沉静
寂静→沉静
沉默→缄默
默然→沉默
沉沦→沉溺
沉溺→沉沦
沉湎→沉沦
沉思→寻思
寻思→沉思
深思→沉思
沉重→繁重
繁重→沉重
晨光→晨曦
晨曦→晨光
陈述→陈说
陈说→陈述
述说→陈述
陈腐→陈旧
陈旧→陈腐
衬托→陪衬
陪衬→衬托
称赞→称颂
称颂→称赞
夸奖→称赞
成功→胜利
胜利→成功
成果→结果
结果→成果
后果→成果
成规→陈规
陈规→成规
成绩→成就
成就→成绩
成就→造诣
造诣→成就
诚恳→恳切
恳切→诚恳
诚心→诚恳
诚挚→真挚
真挚→诚挚
老实→诚实
程度→水平
水平→程度
承诺→许诺
许诺→承诺
允诺→承诺
迟疑→犹豫
犹豫→迟疑
踌躇→迟疑
驰名→驰誉
驰名→闻名
闻名→驰名
持续→连续
连续→持续
继续→持续
耻辱→羞辱
羞辱→耻辱
赤忱→赤心
赤诚→耻辱
赤心→赤忱
丹心→赤忱
斥责→叱责
叱责→斥责
责备→斥责
炽热→灼热
灼热→炽热
充当→充任
充任→充当
充分→充足
充足→充分
充沛→充分
充满→充斥
充斥→充满
充溢→充满
充裕→富余
富余→充裕
富裕→充裕
富足→充裕
冲洗→冲刷
憧憬→向往
向往→憧憬
崇拜→崇敬
崇敬→崇拜
崇高→高尚
高尚→崇高
重复→反复
反复→重复
宠爱→溺爱
溺爱→宠爱
抽泣→抽咽
抽咽→抽泣
抽噎→抽泣
啜泣→抽泣
筹备→准备
准备→筹备
筹办→筹备
筹划→计划
计划→筹划
仇恨→冤仇
冤仇→仇恨
仇恨→痛恨
痛恨→仇恨
憎恨→仇恨
愁闷→忧郁
忧郁→愁闷
郁闷→愁闷
稠密→浓密
浓密→稠密
丑陋→丑恶
丑恶→丑陋
出发→动身
动身→出发
起程→出发
启程→出发
出色→杰出
杰出→出色
卓越→出色
出生→诞生
诞生→出生
出身→出生
出生→出身
出现→呈现
呈现→出现
处分→处罚
处罚→处分
惩罚→处分
处理→处置
处置→处理
处所→地方
地方→处所
耸立→矗立
屹立→矗立
挺立→矗立
揣摩→琢磨
琢磨→揣摩
传播→传布
传布→传播
传闻→风闻
创办→开办
开办→创办
创立→创建
创建→创立
创造→发明
发明→创造
吹捧→吹嘘
吹嘘→吹捧
锤炼→锻炼
锻炼→锤炼
磨炼→锤炼
纯粹→纯洁
纯洁→纯粹
纯正→纯粹
纯真→纯粹
疏忽→忽视
忽视→疏忽
漠视→疏忽
无视→疏忽
花白→斑白
斑白→花白
花费→破费
破费→花费
花样→名堂
名堂→花样
花招→把戏
把戏→花招
华丽→富丽
富丽→华丽
华丽→华美
华美→华丽
滑头→狡黠
狡黠→滑头
刁滑→滑头
滑稽→幽默
幽默→滑稽
诙谐→滑稽
化装→化妆
化妆→化装
怀疑→疑惑
疑惑→怀疑
疑心→怀疑
狐疑→怀疑
欢乐→欢喜
欢喜→欢乐
欢腾→欢跃
欢跃→欢腾
欢乐→欢快
欢快→欢乐
欢畅→欢乐
缓慢→迟缓
迟缓→缓慢
涣散→散漫
散漫→涣散
豢养→喂养
喂养→豢养
幻想→空想
空想→幻想
梦想→幻想
幻灭→破灭
荒废→旷废
荒漠→荒凉
荒凉→荒漠
荒谬→荒诞
荒诞→荒谬
荒唐→荒谬
荒野→荒原
荒原→荒野
荒漠→荒野
慌张→张皇
张皇→慌张
惶恐→惊慌
惊慌→惶恐
谎言→谣言
谣言→谎言
挥动→挥舞
挥舞→挥动
回避→躲避
躲避→回避
逃避→回避
回击→还击
还击→回击
反击→回击
回生→复生
复生→回生
复活→回生
回想→回忆
回忆→回想
回顾→回想
回首→回想
回旋→盘旋
盘旋→回旋
悔过→悔悟
悔悟→悔过
记载→记录
家属→家眷
家眷→家属
嘉奖→奖励
奖励→嘉奖
加强→增强
增强→加强
枷锁→桎梏
桎梏→枷锁
夹杂→搀杂
搀杂→夹杂
假话→谎话
谎话→假话
谎言→假话
假想→设想
设想→假想
假装→伪装
伪装→假装
装作→假装
价格→价钱
价钱→价格
坚固→牢固
牢固→坚固
牢靠→坚固
坚强→顽强
顽强→坚强
艰巨→艰难
艰难→艰巨
艰苦→艰难
艰难→艰苦
困难→艰苦
坚毅→刚毅
刚毅→坚毅
尖锐→尖利
监视→监督
兼顾→统筹
统筹→兼顾
检查→检讨
检讨→检查
反省→检查
检举→揭发
揭发→检举
俭朴→简朴
简朴→俭朴
简洁→简练
简练→简洁
简略→简单
简单→简略
扼要→简要
见面→会晤
会晤→见面
建立→树立
树立→建立
见解→看法
看法→见解
讲解→讲授
讲授→讲解
解说→讲解
讲究→讲求
讲求→讲究
考究→讲究
降落→下降
下降→降落
降低→下降
下降→降低
降生→出世
出世→降生
交错→交织
交织→交错
交换→交流
交流→交换
交界→接壤
骄傲→自豪
自豪→骄傲
高傲→骄傲
狡猾→狡诈
狡诈→狡猾
校订→校正
校正→校订
校对→校订
叫嚷→叫唤
叫唤→叫嚷
叫喊→叫嚷
教导→教诲
教诲→教导
教育→教导
教唆→唆使
唆使→教唆
挑唆→教唆
接济→救济
救济→接济
接收→接受
接受→接收
接管→接收
接洽→联系
联系→接洽
揭露→揭穿
揭穿→揭露
揭发→揭露
揭幕→开幕
开幕→揭幕
结构→构造
构造→结构
结束→停止
停止→结束
收场→结束
节俭→节省
节省→节俭
节约→节俭
节制→控制
控制→节制
解释→说明
说明→解释
解聘→解职
解职→解聘
戒备→防备
防备→戒备
界限→界线
界线→界限
紧急→紧迫
紧迫→紧急
谨慎→谨严
进步→提高
尽情→纵情
纵情→尽情
尽头→止境
止境→尽头
禁止→制止
制止→禁止
阻止→禁止
惊愕→惊诧
惊诧→惊愕
惊慌→惊惶
惊惶→惊慌
惊悸→惊慌
惊恐→惊骇
惊骇→惊恐
惶恐→惊恐
经历→阅历
阅历→经历
出色→精彩
精华→精髓
精良→优良
优良→精良
精美→优美
优美→精美
精悍→精干
精干→精悍
精巧→精致
精致→精巧
精美→精巧
精深→精湛
精湛→精深
深湛→精深
精力→精神
精神→精力
精致→精细
精细→精致
警惕→警戒
警戒→警惕
警惕→小心
小心→警惕
景象→气象
气象→景象
敬慕→仰慕
仰慕→敬慕
敬佩→敬仰
敬仰→敬佩
敬重→敬佩
纠正→改正
改正→纠正
救济→救援
救援→救济
就义→捐躯
捐躯→就义
牺牲→就义
拘束→拘谨
拘谨→拘束
居心→用心
用心→居心
存心→居心
局面→局势
局势→局面
举办→举行
举行→举办
举动→举措
举措→举动
行动→举动
巨大→伟大
伟大→巨大
聚会→聚首
聚首→聚会
拒绝→谢绝
谢绝→拒绝
回绝→拒绝
觉悟→觉醒
觉醒→觉悟
醒悟→觉悟
决裂→破裂
破裂→决裂
分裂→决裂
决定→决议
决议→决定
抉择→决定
崛起→突起
突起→崛起
倔强→顽强
顽强→倔强
开创→首创
首创→开创
创始→开创
开导→劝导
劝导→开导
开端→开始
开始→开端
起头→开端
开口→启齿
开朗→爽朗
开辟→开拓
开拓→开辟
勘察→勘探
勘探→勘察
看待→对待
对待→看待
看法→见地
见地→看法
慷慨→大方
大方→慷慨
考虑→斟酌
斟酌→考虑
考核→考察
考察→考核
考查→考核
苛刻→刻薄
刻薄→苛刻
可贵→宝贵
宝贵→可贵
珍贵→可贵
可怕→恐怖
恐怖→可怕
渴望→盼望
盼望→渴望
刻画→描绘
描绘→刻画
克服→战胜
战胜→克服
克制→抑制
抑制→克制
恳求→请求
请求→恳求
空洞→空泛
空泛→空洞
恐吓→威吓
威吓→恐吓
恐怖→恐惧
恐惧→恐怖
控告→控诉
控诉→控告
控制→掌握
掌握→控制
口气→口吻
哭泣→呜咽
呜咽→哭泣
啼哭→哭泣
苦楚→痛楚
痛楚→苦楚
痛苦→苦楚
夸张→夸大
夸大→夸张
夸耀→夸奖
夸奖→夸耀
炫耀→夸耀
称赞→夸奖
赞美→夸奖
快活→快乐
快乐→快活
宽大→广大
广大→宽大
宽阔→宽敞
宽敞→宽阔
狂妄→傲慢
傲慢→狂妄
窥测→窥伺
窥伺→窥测
窥探→窥测
亏本→赔本
赔本→亏本
蚀本→亏本
魁梧→魁伟
魁伟→魁梧
困乏→困倦
困惑→迷惑
迷惑→困惑
疑惑→困惑
扩大→扩展
扩展→扩大
扩张→扩大
阔气→阔绰
阔绰→阔气
拉拢→笼络
笼络→拉拢
邋遢→肮脏
肮脏→邋遢
来往→交往
交往→来往
拦阻→拦截
拦截→拦阻
阻挡→拦阻
懒惰→懒散
懒散→懒惰
浪费→挥霍
挥霍→浪费
牢固→稳固
稳固→牢固
牢骚→怨言
怨言→牢骚
劳碌→忙碌
忙碌→劳碌
老练→干练
干练→老练
累赘→包袱
包袱→累赘
负担→累赘
雷同→相同
相同→雷同
类似→相似
相似→类似
冷淡→冷漠
冷漠→冷淡
冷酷→冷淡
冷清→冷僻
冷僻→冷清
冷静→沉着
沉着→冷静
离开→分开
分开→离开
理想→幻想
幻想→理想
利益→好处
好处→利益
利用→应用
应用→利用
力量→力气
力气→力量
气力→力量
廉洁→廉明
廉明→廉洁
廉正→廉洁
连接→衔接
衔接→连接
连累→牵连
牵连→连累
株连→连累
联合→结合
结合→联合
脸色→神色
神色→脸色
凉快→凉爽
凉爽→凉快
粮食→食粮
食粮→粮食
缭绕→围绕
围绕→缭绕
萦绕→缭绕
料想→猜想
猜想→料想
裂缝→裂痕
邻近→临近
吝啬→小气
小气→吝啬
凌晨→清晨
清晨→凌晨
早晨→凌晨
凌辱→侮辱
侮辱→凌辱
零碎→零星
零星→零碎
零散→零碎
灵活→灵巧
灵巧→灵活
灵便→灵活
领会→体会
体会→领会
领导→引导
引导→领导
指导→领导
领域→范畴
范畴→领域
浏览→阅读
阅读→浏览
涉猎→浏览
流畅→流利
流利→流畅
流传→传播
传播→流传
流浪→流落
流落→流浪
漂泊→流浪
流露→吐露
吐露→流露
透露→流露
流言→谣言
谣言→流言
留心→留意
留意→留心
留神→留心
隆重→盛大
盛大→隆重
笼罩→覆盖
覆盖→笼罩
漏洞→破绽
破绽→漏洞
履行→实行
实行→履行
执行→履行
掠夺→抢夺
抢夺→掠夺
掠取→掠夺
沦陷→失守
失守→沦陷
论述→阐述
阐述→论述
裸露→袒露
袒露→裸露
暴露→裸露
落后→落伍
落伍→落后
后进→落后
麻痹→麻木
埋伏→潜伏
潜伏→埋伏
买通→打通
蛮横→野蛮
野蛮→蛮横
谩骂→漫骂
漫骂→谩骂
忙乱→慌乱
慌乱→忙乱
莽撞→鲁莽
鲁莽→莽撞
冒失→莽撞
毛病→缺点
缺点→毛病
错误→毛病
茂盛→旺盛
旺盛→茂盛
美好→美妙
美妙→美好
美丽→漂亮
漂亮→美丽
标致→美丽
美满→圆满
圆满→美满
门路→途径
途径→门路
路子→门路
蒙受→承受
承受→蒙受
迷恋→留恋
留恋→迷恋
依恋→迷恋
弥补→填补
填补→弥补
密切→亲密
亲密→密切
绵延→连绵
连绵→绵延
缅怀→怀念
怀念→缅怀
免职→撤职
撤职→免职
罢免→免职
勉励→鼓励
鼓励→勉励
面貌→面孔
面孔→面貌
苗条→修长
修长→苗条
描写→描述
描述→描写
描绘→描写
渺小→微小
微小→渺小
细小→渺小
灭亡→消亡
消亡→灭亡
敏锐→灵敏
灵敏→敏锐
明白→清楚
清楚→明白
明确→明白
明白→明确
明显→显明
显明→明显
明显→显著
铭记→铭刻
铭刻→铭记
名誉→声誉
声誉→名誉
声望→名誉
名贵→宝贵
宝贵→名贵
珍贵→名贵
命根子→命脉
摸索→探索
探索→摸索
模仿→模拟
模拟→模仿
抹杀→扼杀
陌生→生疏
生疏→陌生
牟取→攫取
攫取→牟取
夺取→牟取
目标→目的
目的→目标
募捐→捐献
捐献→募捐
耐心→耐烦
耐烦→耐心
恼怒→愤怒
愤怒→恼怒
内行→行家
行家→内行
里手→内行
内耗→内讧
内讧→内耗
内幕→内情
内情→内幕
能力→才能
才能→能力
能人→强人
强人→能人
年纪→年事
年事→年纪
年龄→年纪
年轻→年青
捏造→假造
假造→捏造
伪造→捏造
凝聚→凝集
凝集→凝聚
注视→凝视
凝听→聆听
聆听→凝听
忸怩→腼腆
浓重→浓厚
浓厚→浓重
怒吼→咆哮
咆哮→怒吼
努力→尽力
尽力→努力
讴歌→赞美
赞美→讴歌
偶合→巧合
排挤→排斥
排斥→排挤
排除→消除
消除→排除
徘徊→彷徨
彷徨→徘徊
攀登→攀缘
攀缘→攀登
盘算→计算
计算→盘算
盘踞→占据
占据→盘踞
盘点→清点
叛逃→潜逃
盼望→希望
希望→盼望
抛弃→摈弃
摈弃→抛弃
遗弃→抛弃
咆哮→呼啸
培养→培育
培育→培养
培植→培养
陪伴→陪同
陪同→陪伴
佩服→信服
信服→佩服
抨击→鞭挞
鞭挞→抨击
批评→批驳
批驳→批评
批判→批评
批准→同意
同意→批准
疲惫→疲乏
疲乏→疲惫
疲倦→疲惫
僻静→寂静
寂静→僻静
清静→僻静
偏见→成见
成见→偏见
偏向→倾向
倾向→偏向
便宜→廉价
廉价→便宜
片断→片段
骗局→圈套
圈套→骗局
飘扬→飘荡
飘荡→飘扬
招展→飘扬
品德→品格
品格→品德
品质→品德
聘请→聘任
聘任→聘请
聘用→聘请
平常→平凡
平凡→平常
平静→镇静
镇静→平静
平庸→平淡
平淡→平庸
魄力→气魄
气魄→魄力
迫害→危害
危害→迫害
破除→废除
废除→破除
破绽→马脚
朴素→朴实
朴实→朴素
期待→等待
等待→期待
欺负→欺侮
欺侮→欺负
欺凌→欺负
欺压→欺负
欺骗→诈骗
诈骗→欺骗
漆黑→黝黑
黝黑→漆黑
旗帜→旗号
旗号→旗帜
奇特→独特
独特→奇特
奇怪→奇异
奇异→奇怪
奇妙→巧妙
巧妙→奇妙
歧视→轻视
轻视→歧视
启发→启示
启示→启发
启迪→启发
企图→妄图
妄图→企图
起源→来源
来源→起源
滥觞→起源
气度→气宇
气宇→气度
气氛→氛围
氛围→气氛
气势→气概
气概→气势
气味→气息
气象→气候
气候→气象
天气→气象
器重→重视
重视→器重
谦恭→谦和
谦和→谦恭
谦虚→谦逊
谦逊→谦虚
签订→签署
签署→签订
迁就→姑息
姑息→迁就
前途→前程
前程→前途
出路→前途
虔诚→忠诚
忠诚→虔诚
潜藏→躲藏
躲藏→潜藏
浅易→浅近
浅近→浅易
浅显→浅易
浅薄→浅陋
浅陋→浅薄
强大→强盛
强横→强暴
强暴→强横
强健→强壮
强壮→强健
强制→强迫
强迫→强制
抢救→挽救
挽救→抢救
俏丽→美丽
美丽→俏丽
切磋→商讨
商讨→切磋
亲切→亲热
亲热→亲切
亲信→心腹
心腹→亲信
侵害→损害
损害→侵害
侵犯→侵略
侵略→侵犯
侵占→侵犯
侵犯→侵占
勤恳→勤奋
勤奋→勤恳
勤勉→勤恳
勤俭→节约
节约→勤俭
清除→肃清
肃清→清除
清算→清理
清理→清算
清贫→贫寒
贫寒→清贫
清高→高傲
高傲→清高
清香→幽香
幽香→清香
清新→清爽
清爽→清新
清瘦→清癯
清楚→清晰
倾注→倾泻
倾销→推销
轻浮→轻佻
轻佻→轻浮
轻巧→轻盈
情愿→宁愿
宁愿→情愿
甘愿→情愿
情感→感情
感情→情感
情况→情形
情形→情况
情绪→情感
情感→情绪
情势→形式
形式→情势
情义→情谊
情谊→情义
情意→情义
请求→要求
要求→请求
庆祝→庆贺
庆贺→庆祝
祝贺→庆祝
屈服→屈从
屈从→屈服
服从→屈服
驱赶→驱逐
驱逐→驱赶
曲折→崎岖
崎岖→曲折
曲解→歪曲
歪曲→曲解
误解→曲解
取消→撤消
撤消→取消
取缔→取消
权利→权力
权力→权利
权威→威望
威望→权威
权势→势力
势力→权势
全部→全体
全体→全部
整个→全部
劝告→奉劝
劝说→劝告
劝导→疏导
疏导→劝导
缺点→缺陷
缺陷→缺点
缺乏→缺少
缺少→缺乏
短缺→缺乏
确定→肯定
肯定→确定
确实→确切
确切→确实
确凿→确实
让步→妥协
妥协→让步
退让→让步
扰乱→捣乱
捣乱→扰乱
热爱→酷爱
酷爱→热爱
热门→热点
热情→热忱
热忱→热情
热心→热情
热烈→热闹
热闹→热烈
仁慈→善良
善良→仁慈
忍耐→忍受
忍受→忍耐
忍让→谦让
谦让→忍让
以为→认为
觉得→认为
任务→义务
义务→任务
融合→融会
融会→融合
交融→融合
融化→熔化
熔化→融化
荣幸→幸运
幸运→荣幸
荣誉→声誉
声誉→荣誉
容许→允许
允许→容许
蹂躏→践踏
践踏→蹂躏
软禁→囚禁
囚禁→软禁
幽禁→软禁
软弱→脆弱
脆弱→软弱
薄弱→软弱
修饰→润饰
润色→润饰
撒手→放手
放手→撒手
撒野→撒泼
撒泼→撒野
散布→分布
分布→散布
散播→散布
散步→漫步
漫步→散步
溜达→散步
丧失→损失
损失→丧失
丢失→丧失
骚乱→动乱
动乱→骚乱
扫除→清除
清除→扫除
扫兴→失望
失望→扫兴
色彩→颜色
颜色→色彩
杀害→杀戮
杀戮→杀害
闪耀→闪烁
闪烁→闪耀
擅长→善于
善于→擅长
长于→擅长
商量→磋商
磋商→商量
商议→商讨
商讨→商议
商榷→商议
伤害→损害
损害→伤害
危害→伤害
上当→受骗
受骗→上当
烧毁→销毁
销毁→烧毁
奢侈→奢靡
设备→装备
装备→设备
深奥→深邃
深邃→深奥
深入→深刻
深刻→深入
申述→申说
申说→申述
申诉→申述
申明→声名
身材→身体
身体→身材
神情→神色
神色→神情
神采→神情
神往→向往
向往→神往
审判→审讯
慎重→稳重
稳重→慎重
声调→音调
音调→声调
腔调→声调
声援→支援
支援→声援
生僻→冷僻
冷僻→生僻
生动→活泼
活泼→生动
生命→性命
性命→生命
生活→生涯
生涯→生活
牲畜→畜生
畜生→牲畜
牲口→牲畜
失望→绝望
绝望→失望
失职→渎职
渎职→失职
发挥→施展
实行→实施
实施→实行
实用→适用
适用→实用
时间→时光
时光→时间
光阴→时间
时代→时期
时期→时代
时兴→时髦
时髦→时兴
实验→试验
试验→实验
视察→观察
观察→视察
嗜好→癖好
事迹→业绩
业绩→事迹
逝世→去世
去世→逝世
死→逝世
适当→恰当
恰当→适当
收藏→珍藏
收复→光复
光复→收复
克复→收复
收留→收容
收买→拉拢
拉拢→收买
收拾→整理
整理→收拾
手段→手腕
手腕→手段
手法→手段
守卫→保卫
保卫→守卫
输赢→胜负
胜负→输赢
舒服→舒畅
舒畅→舒服
束缚→约束
约束→束缚
疏散→分散
分散→疏散
熟悉→熟习
熟习→熟悉
熟识→熟悉
衰弱→虚弱
虚弱→衰弱
爽直→爽快
爽快→爽直
思念→怀念
怀念→思念
伺机→乘机
苏醒→清醒
清醒→苏醒
随便→随意
随意→随便
损坏→破坏
破坏→损坏
毁坏→损坏
唆使→指示
指示→唆使
谈判→会谈
会谈→谈判
坦率→坦白
坦白→坦率
探听→打听
打听→探听
探问→探听
探询→探听
搪塞→敷衍
敷衍→搪塞
逃亡→流亡
流亡→亡命
亡命→流亡
沉醉→陶醉
特别→特殊
特殊→特别
特点→特色
特色→特点
特征→特点
特性→特征
腾飞→起飞
提倡→倡导
倡导→提倡
提示→提醒
提醒→提示
提升→晋升
提拔→选拔
选拔→提拔
体格→体魄
体魄→体格
体谅→谅解
谅解→体谅
甜蜜→甜美
调解→调停
调停→调处
调处→调解
调剂→调解
调解→调剂
调整→调剂
挑拨→挑唆
挑唆→挑拨
挑衅→挑战
挑战→挑衅
停止→停滞
停滞→停止
挺拔→挺立
挺立→挺拔
通讯→通信
同学→同窗
同窗→同学
同意→赞成
赞成→同意
偷盗→偷窃
偷窃→偷盗
盗窃→偷盗
头脑→脑筋
脑筋→头脑
脑子→头脑
投奔→投靠
投靠→投奔
透彻→透辟
透辟→透彻
屠杀→屠戮
屠戮→屠杀
杀戮→屠杀
团体→集团
推辞→推脱
推脱→推辞
推卸→推辞
推戴→拥戴
拥戴→推戴
推动→推进
推进→推动
推荐→推举
推举→推荐
推选→推荐
推敲→斟酌
斟酌→推敲
推让→谦让
谦让→推让
推重→推许
推许→推重
推崇→推重
颓废→颓丧
颓丧→颓废
吞没→淹没
淹没→吞没
拖拉→拖沓
拖沓→拖拉
疲塌→拖拉
妥当→妥善
妥善→妥当
妥帖→妥当
挖苦→奚落
奚落→挖苦
弯曲→曲折
曲折→弯曲
完善→完美
完美→完善
完整→完全
完全→完整
惋惜→可惜
可惜→惋惜
婉转→悠扬
悠扬→婉转
忘记→忘却
忘却→忘记
忘怀→忘记
妄想→妄图
妄图→妄想
梦想→妄想
消耗→消费
消除→清除
清除→消除
消散→消失
消失→消散
消失→消逝
消逝→消失
消息→新闻
新闻→消息
小心→当心
当心→小心
效果→后果
后果→效果
效率→效力
效力→效率
笑容→笑颜
笑颜→笑容
笑貌→笑容
笑脸→笑容
协议→协定
协定→协议
协调→调和
调和→协调
泄漏→泄露
泄露→泄漏
透露→泄漏
辛劳→辛苦
辛勤→辛苦
新鲜→新颖
新颖→新鲜
心肠→心地
心地→心肠
心情→心境
心境→心情
心坎→心田
心田→心坎
内心→心坎
信用→信誉
信誉→信用
信心→信念
信念→信心
信任→信赖
信赖→信任
相信→信任
行动→行为
行为→行动
行径→行动
性格→性情
性情→性格
脾气→性格
兴趣→兴致
兴致→兴趣
凶狠→凶恶
凶恶→凶狠
凶暴→凶狠
凶猛→凶悍
凶悍→凶猛
雄壮→雄浑
雄浑→雄壮
雄健→雄壮
修正→修改
修改→修正
需要→须要
须要→需要
虚伪→虚假
虚假→虚伪
宣传→宣扬
宣扬→宣传
鼓吹→宣传
宣告→宣布
宣布→宣告
削弱→减弱
减弱→削弱
血汗→心血
心血→血汗
巡视→巡查
巡查→巡视
询问→讯问
讯问→询问
驯服→征服
征服→驯服
寻求→追求
追求→寻求
寻衅→挑衅
挑衅→寻衅
迅速→敏捷
敏捷→迅速
压缩→紧缩
紧缩→压缩
收缩→压缩
压抑→压制
压制→压抑
雅观→美观
美观→雅观
严格→严厉
严厉→严格
严峻→严格
严正→严肃
严肃→严正
研究→研讨
研讨→研究
钻研→研究
延伸→延长
延长→延伸
演变→演化
演化→演变
蜕变→演变
掩盖→掩饰
掩饰→掩盖
掩护→保护
保护→掩护
眼光→目光
目光→眼光
眼力→眼光
眼光→眼力
厌烦→腻烦
腻烦→厌烦
养活→赡养
赡养→养活
要挟→威胁
威胁→要挟
要害→关键
关键→要害
依附→依靠
依靠→依附
依赖→依附
遗言→遗嘱
遗嘱→遗言
遗愿→遗言
意见→看法
看法→意见
阴森→阴沉
阴沉→阴森
隐蔽→隐藏
隐藏→隐蔽
隐约→模糊
模糊→隐约
引诱→引导
引导→引诱
诱导→引诱
应当→应该
应该→应当
该当→应当
理当→应当
英灵→英魂
英魂→英灵
英俊→俊秀
俊秀→英俊
英俊→漂亮
漂亮→英俊
英雄→豪杰
豪杰→英雄
英豪→英雄
英勇→勇敢
勇敢→英勇
勇猛→英勇
逢迎→迎合
迎合→逢迎
投合→逢迎
营生→谋生
谋生→营生
营养→养分
养分→营养
硬朗→结实
结实→硬朗
健壮→硬朗
拥护→拥戴
拥戴→拥护
庸俗→俗气
俗气→庸俗
勇敢→大胆
大胆→勇敢
涌现→出现
出现→涌现
用处→用途
用途→用处
用场→用处
优点→长处
优良→优秀
优秀→优良
优异→优良
优越→优胜
优美→幽美
幽美→优美
幽深→幽邃
幽邃→幽深
悠久→悠长
悠长→悠久
友谊→友情
友情→友谊
友爱→友好
友好→友爱
诱骗→欺骗
欺骗→诱骗
迂腐→陈腐
陈腐→迂腐
愚蠢→愚昧
愚昧→愚蠢
愚笨→愚蠢
预感→预见
预见→预感
预料→预感
预兆→前兆
前兆→预兆
先兆→预兆
圆滑→油滑
油滑→圆滑
世故→圆滑
原谅→谅解
谅解→原谅
援助→支援
支援→援助
赞助→援助
远景→前景
愿望→欲望
欲望→愿望
希望→愿望
约定→商定
允许→许可
许可→允许
蕴藏→储藏
运动→活动
活动→运动
运用→应用
应用→运用
使用→应用
杂念→邪念
灾害→灾祸
灾祸→灾害
灾难→灾害
赞美→赞扬
赞扬→赞赏
赞颂→赞扬
赞赏→赞美
赞成→赞同
赞同→赞成
赞许→赞成
赞助→资助
资助→赞助
帮助→赞助
糟蹋→浪费
浪费→糟蹋
遭遇→遭受
遭受→遭遇
蒙受→遭遇
造就→培养
培养→造就
责备→责怪
责怪→责备
指责→责备
责任→义务
义务→责任
增加→增添
增添→增加
增进→促进
促进→增进
支援→增援
增长→增加
增加→增长
沾染→感染
感染→沾染
传染→沾染
展现→展示
展示→展现
占领→占据
占据→占领
占有→占领
战斗→战役
战役→战斗
战争→战斗
张望→观望
观望→张望
招待→接待
接待→招待
款待→招待
招呼→召唤
召唤→招呼
朝气→生气
生气→朝气
着急→焦急
焦急→着急
照顾→照料
照料→照顾
照应→照顾
照射→照耀
照耀→照射
召唤→呼唤
呼唤→召唤
遮蔽→掩蔽
掩蔽→遮蔽
遮掩→遮蔽
折衷→调和
调和→折衷
珍爱→珍重
珍重→珍爱
珍惜→珍爱
真诚→真挚
真挚→真诚
热诚→真诚
真理→真谛
真谛→真理
侦察→侦查
侦查→侦察
震动→震撼
震撼→震动
震荡→震动
镇静→沉着
沉着→镇静
症结→关键
关键→症结
争辩→辩论
辩论→争辩
争论→争辩
争取→争夺
争夺→争取
整理→整顿
整顿→整理
正确→准确
正直→正派
正派→正直
郑重→慎重
慎重→郑重
支撑→支持
支持→支撑
直爽→直率
直率→直爽
指导→指点
指点→指导
指示→指导
制定→制订
制订→制定
制作→制造
制造→制作
忠诚→忠实
忠实→忠诚
忠厚→忠诚
中断→中止
中止→中断
重任→重担
重担→重任
重视→看重
看重→重视
注重→重视
重要→主要
主要→重要
首要→重要
周到→周密
周密→周到
周密→严密
严密→周密
缜密→周密
咒骂→诅咒
诅咒→咒骂
谩骂→咒骂
主动→自动
自动→主动
主意→主张
主张→主意
主见→主意
祝贺→祝愿
祝愿→祝贺
注视→注目
注目→注视
瞩目→注视
著名→有名
有名→著名
知名→著名
专长→特长
特长→专长
转变→改变
改变→转变
转达→传达
传达→转达
装饰→装潢
装潢→装饰
壮大→强大
强大→壮大
壮丽→绚丽
绚丽→壮丽
壮实→结实
结实→壮实
状态→状况
状况→状态
追随→跟随
跟随→追随
预备→准备
准确→精确
精确→准确
拙劣→低劣
低劣→拙劣
卑劣→拙劣
卓越→卓著
卓著→卓越
着重→侧重
侧重→着重
偏重→着重
姿势→姿态
姿态→姿势
资格→资历
资历→资格
滋生→滋长
滋长→滋生
仔细→细心
细心→仔细
自负→自信
自信→自负
自傲→自负
自满→骄傲
骄傲→自满
自诩→自夸
宗旨→主旨
主旨→宗旨
踪影→踪迹
踪迹→踪影
走狗→走卒
走卒→走狗
阻止→阻拦
阻挠→阻拦
阻拦→阻挡
阻挡→阻拦
罪恶→罪行
罪行→罪恶
罪责→罪恶
尊重→尊敬
尊敬→尊重
遵守→遵照
遵照→遵守
遵循→遵守
作怪→作祟
作祟→作怪
作风→风格
风格→作风
旺盛→兴旺
兴旺→旺盛
威信→威望
威望→威信
威胁→威逼
威逼→威胁
微妙→奥妙
奥妙→奇妙
奇妙→奥妙
违反→违背
违抗→违背
为难→难堪
难堪→为难
尴尬→为难
围绕→环绕
环绕→围绕
环抱→围绕
伟人→巨人
巨人→伟人
畏惧→害怕
害怕→畏惧
慰问→慰劳
慰劳→慰问
温和→平和
平和→温和
暖和→温暖
温柔→温顺
温顺→温柔
和顺→温柔
稳固→稳定
稳定→稳固
稳重→庄重
庄重→稳重
持重→稳重
诬陷→诬告
诬告→诬陷
无私→忘我
忘我→无私
无穷→无限
误会→误解
误解→误会
物质→物资
物资→物质
吸收→接收
接收→吸收
稀疏→稀少
稀少→稀疏
希奇→希罕
希罕→希奇
习性→习惯
习气→习惯
喜报→捷报
系统→体系
体系→系统
细长→修长
修长→细长
狭窄→狭小
狭小→狭窄
下流→下贱
下贱→下流
先辈→前辈
前辈→先辈
贤明→英明
英明→贤明
相干→相关
相关→相干
想念→惦念
惦念→想念
响亮→洪亮
洪亮→响亮
嘹亮→响亮
消费→花费
花费→消费
福寿膏→阿芙蓉
那个→阿谁
姨妈→阿姨
谄谀→阿谀
攀龙趋凤→阿谀奉承
攀龙趋凤→阿谀奉迎
愁肠寸断→哀肠百转
悲悼→哀悼
恳求→哀告
悲啼→哀号
灾民→哀鸿
百孔千疮→哀鸿遍野
悯恻→哀怜
恳求→哀求
悲悼→哀伤
悲痛→哀思
悲伤→哀痛
顺序→挨次
受饿→挨饿
靠拢→挨近
和蔼可亲→蔼然可亲
求贤若渴→爱才如命
求贤若渴→爱才若命
一毛不拔→爱财如命
尊崇→爱崇
恋慕→爱戴
敬服→爱护
珍惜→爱护保重
恋慕→爱慕
宠姬→爱妾
恋爱→爱情
己饥己溺→爱人如己
敬服→爱惜
居安思危→安不忘危
漫步→安步
缓步徐行→安步当车
布置→安插
顺产→安产
稳固→安定
布置→安顿
安顿→安放
循分→安分
循规蹈矩→安分守纪
抚慰→安抚
宁静→安好
克绍箕裘→安家立业
安定→安靖
平静→安静冷静僻静
安身立命→安居乐业
愉逸→安乐
安定→安谧
摆设→安排
宁静→安全
平安→安然
平和→安然平静
平安无事→安然无事
平安无事→安然无恙
固若金汤→安如盘石
固若金汤→安如泰山
十拿九稳→安若泰山
安置→安设
立足→安身
安居乐业→安身立命
宁静→安适
安分守己→安守故常
安乐→安泰
妥当→安妥
同甘共苦→安危与共
慰藉→安慰
牢固→安稳
歇息→安息
安逸→安闲
宁静→安详
平静→安祥
歇息→安歇
放心→安心
清闲→安逸
扎营→安营
自暴自弃→安于现状
何在→安在
埋葬→安葬
高枕无忧→安枕无忧
怎知→安知
布置→安置
安置→安装
循规蹈矩→按部就班
顺序→按次
照例→按例
推拿→按摩
抑制→按捺
定期→按期
定时→按时
刻舟求剑→按图索骥
顺次→按序
根据→按照
文案→案牍
档册→案卷
悄悄→暗暗
潜伏→暗藏
暗流→暗潮
昏暗→暗淡
惨淡→暗澹
冷战→暗斗
阴沟→暗沟
谋害→暗害
灯号→暗号
灯号→暗记
冷箭→暗箭
含沙射影→暗箭伤人
私下→暗里
暗潮→暗流
密码→暗码
黑市→暗盘
谋害→暗杀
影射→暗射
表示→暗示
暗杀→暗算
天昏地暗→暗无天日
窃笑→暗笑
切口→暗语
黑暗→暗中
抬头→昂首
傲睨一世→昂首望天
洼地→凹地
高低→凹凸
折磨→熬煎
锻炼→熬炼
高傲→傲岸
渺视→傲睨
傲世轻物→傲睨万物
傲睨万物→傲睨一世
傲睨万物→傲世轻物
睥睨→傲视
坚贞不屈→傲雪欺霜
骄兵必败→傲卒多败
骄兵必败→傲卒多降
秘密→奥秘
秘密→奥密
玄妙→奥妙
悔恨→懊悔
悔恨→懊丧
四行孤军→八百壮士
才高八斗→八斗之才
四面楚歌→八方受敌
八棍子撂不着→八竿子打不着
陈腔滥调→八股
稀奇古怪→八怪七喇
八竿子打不着→八棍子撂不着
不相上下→八两半斤
五花八门→八门五花
八面玲珑→八面见光
八面见光→八面玲珑
四面楚歌→八面受敌
气势汹汹→八面威风
发草帖→八字帖
逢迎→巴结
渴望→巴望
翦绺→扒手
废除→拔除
起锚→拔锚
适得其反→拔苗助长
选取→拔取
扶植→拔擢
猖→跋扈
进退失据→跋前疐后
动辄得咎→跋前踬后
后记→跋文
促膝谈心→把臂而谈
痛处→把柄
切脉→把脉
看管→把守
戏弄→把玩簸弄
当心→把稳
驾驭→把握
歇工→罢工
而已→罢了
撤职→罢免
歇手→罢手
放手→罢休
蛮横→霸道
机谋→霸术
攻克→霸占
呆子→白痴
白费→白搭
鹤发→白发
皓首苍颜→白发苍颜
庞眉皓发→白发银须
白搭→白费
枉费心机→白费心血
口语→白话
光阴似箭→白驹过隙
石蜡→白腊
洋蜡→白蜡
白天→白日
白日升天→白日飞升
白日飞升→白日升天
空手→白手
自食其力→白手起家
老人→白叟
白昼→白天
沧海桑田→白云苍狗
碧眼儿→白种人
白天→白昼
利剑→白
千般→百般
百发百中→百步穿杨
扶摇直上→百尺竿头
有口难言→百辞莫辩
矢无虚发→百发百中
民生凋敝→百孔千疮
合家→百口
寥寥无几→百里挑一
千了百当→百了千当
鸭蛋虽密也有缝→百密一疏
大惑不解→百思不解
童言无忌→百无禁忌
黎民→百姓
视为心腹→百依百顺
势如破竹→百战百胜
一往直前→百折不回
百折不回→百折不挠
左右→摆布
动摇→摆荡
搭架子→摆架子
排列→摆列
部署→摆设
开脱→摆脱
腐败→败北
松弛→败坏
倾家荡产→败尽家业
莠民→败类
败事→败露
败露→败事
没趣→败兴
劣行→败行
换帖兄弟→拜把兄弟
离别→拜别
造访→拜访
求神拜鬼→拜鬼求神
访问→拜候
参见→拜见
贺年→拜年
托付→拜托
访候→拜望
拜望→拜谒
纠缠不清→扳缠不清
攀谈→扳话
连累→扳连
交谈→扳谈
布鼓雷门→班门弄斧
凯旅→班师
盘游→般游
颁发→颁布
宣布→颁布发表
发表→颁发
美丽→斑斓
花纹→斑纹
搬家→搬场
挪动转移→搬动
搬迁→搬家
挑衅→搬弄
挑拨离间→搬弄是非
搬家→搬迁
木屋→板屋
呆滞→板滞
邦畿→版图
办妥→办好
管理→办理
服务→办事
办好→办妥
豆剖瓜分→半壁江山
旗鼓相当→半斤八两
片刻→半晌
对折→半数
中途→半途
功败垂成→半途而废
欲言又止→半吐半吞
不即不离→半推半就
将信将疑→半信半疑
子夜→半夜
东床→半子
伙计→伴计
朋友→伴侣
陪同→伴随
随同→伴同
饰演→扮演
化装→扮装
拌杂→拌合
拌合→拌杂
国脉→邦本
版图→邦畿
国家荣誉→邦家之光
国交→邦交
光顾→帮衬
帮助→帮忙
帮忙→帮手
资助→帮助
捆绑→绑缚
署书→榜书
当中→傍边
旁观→傍观
歪路→傍门
目中无人→傍若无人
篾片→傍友
包揽→包办
心怀叵测→包藏祸心
保证→包管
包罗→包含
包容→包涵
包罗→包括
包办→包揽
包括→包罗
应有尽有→包罗万象
包涵→包容
困绕→包围
包括→包孕
批驳→褒贬
宝物→宝贝
大札→宝缄
浮图→宝塔
宝贝→宝物
铜山→宝穴
坚苦卓绝→饱经风霜
餍饫→饱食
警卫→保镳
收藏→保藏
连结→保持
生存→保存
推荐→保举
守旧→保守
调养→保养
包管→保证
营垒→堡垒
人为→报酬
报酬→报答
抨击→报复
陈诉→报告
汇报→报告请示
应命→报命
得病→抱病
行侠仗义→抱不平
固步自封→抱残守缺
理想→抱负
怀愁→抱恨
抱歉→抱愧
抱冤→抱屈
捧头→抱头
抱屈→抱冤
遁世→豹隐
暴乱→暴动
狂风→暴风
罪恶滔天→暴戾恣睢
袒露→暴露
原形毕露→暴露无遗
暴动→暴乱
狠毒→暴虐
大发雷霆→暴跳如雷
急躁→暴躁
虐政→暴政
发作→爆发
爆竹→爆仗
爆仗→爆竹
鄙俚→卑鄙
卑躬屈膝→卑恭屈节
猥贱→卑贱
鬼蜮伎俩→卑劣手段
奴视→卑视
草木皆兵→杯弓蛇影
人浮于事→杯水车薪
悲凉→悲惨
追悼→悲悼
灰心→悲观
离合悲欢→悲欢离合
悲惨→悲凉
楚切→悲凄
悲伤→悲戚
悲啼→悲泣
伤心→悲伤
叹伤→悲叹
悲泣→悲啼
悲痛→悲恸
悲伤→悲痛
碑帖→碑本
碑本→碑帖
斗极→北斗
寒风→北风
勾栏→北里
破釜沉舟→背城借一
南辕北辙→背道而驰
后手→背工
配景→背景
反面→背面
叛逆→背叛
背约→背信
背信→背约
孤注一掷→背注一掷
受宠若惊→被宠若惊
受骗→被骗
当选→被选
奔忙→奔波
旷达→奔放
奔驰→奔腾
驱驰→奔走
跋山涉水→奔走风尘
当地→本地
土产→本地货
天职→本分
祖籍→本籍
同族→本家
正事主→本家儿
舍本逐末→本末倒置
本末倒置→本末颠倒
职能→本能机能
今年→本年
资本→本钱
即日→本日
实质→本色
自己→本身
正事主→本事儿
个人主义→本位主义
本旨→本心
个性难改→本性难移
本心→本意天良
来源根基→本原
本心→本旨
素质→本质
簿本→本子
笨蛋→笨伯
笨伯→笨蛋
傻里傻气→笨头笨脑
鸠拙→笨拙
倾圯→崩裂
迫近→逼近
迫良为娼→逼良为娼
欺压→逼迫
铤而走险→逼上梁山
传神→逼真
始祖→鼻祖
触目皆是→比比皆是
等到→比及
比力→比较
最近→比来
比较→比力
同等看待→比量齐观
相比→比拟
连年→比年
比岁不登→比年不登
角逐→比赛
指手画脚→比手划脚
比年不登→比岁不登
交锋→比武
夫唱妇随→比翼双飞
青天→彼苍
相互→彼此
挥洒自如→笔底生花
卖文为活→笔耕墨耘
字迹→笔迹
条记→笔记
凭单→笔据
翰墨→笔墨
鸾翔凤翥→笔走龙蛇
管见→鄙见
卑鄙→鄙俚
吝啬→鄙吝
猥琐→鄙陋
在下→鄙人
藐视→鄙视
卑鄙→鄙俗
俗不可耐→鄙俗不堪
粗言→鄙言
俗语→鄙谚
鄙视→鄙夷
愚见→鄙意
迫不得已→必不得已
肯定→必定
恭恭敬敬→必恭必敬
一定→必然
须要→必要
断命→毕命
一举而竟全功→毕其功于一役
终生一生没世→毕生
结业→毕业
缄口→闭口
缄口结舌→闭口无言
杜门不出→闭门不出
关门落锁→闭门塞窦
凭空捏造→闭门造车
解散→闭幕
花容月貌→闭月羞花
保护→庇护
荫庇→庇荫
寒家→敝宅
毛病→弊端
葱茏→碧绿
白种人→碧眼儿
避忌→避讳
逃难→避祸
避讳→避忌
制止→避免
遁迹→避难
躲债→避债
边疆→边陲
相貌→边幅
界限→边界
疆域→边境
主笔→编缉
辑录→编录
纪年→编年
点窜→编削
体例→编制
入木三分→鞭辟入里
推动→鞭策
跌价→贬价
抑低→贬抑
便利→便当
燕服→便服
私函→便函
即是→便是
条子→便条
自制→便宜
酿成→变成
变更→变动
厘革→变革
变动→变更
变革→变化
变化无穷→变化多端
变化多端→变化无穷
幻化→变幻
变化多端→变幻莫测
变更→变换
背叛→变节
事故→变乱
各处→遍地
普遍→遍及
体无完肤→遍体鳞伤
剖白→辨白
辩解→辩白
反驳→辩驳
谈锋→辩才
辩说→辩论
辩论→辩说
特出→彪炳
斥候→标兵
方向→标的目的
标记→标识表记标帜
题目→标题问题
别开生面→标新立异
口号→标语
漂亮→标致
表明→表白
内外→表里
暴露→表露
楷模→表率
外貌→表面
评释→表明
心情→表情
亮相→表态
体现→表现
演出→表演
别开生面→别出机杼
外传→别传
另外→别的
别开生面→别具一格
别出心裁→别开生面
分别→别离
又名→别名
野史→别史
一无长物→别无长物
剖辨→别析
醉翁之意→别有用心
新奇→别致
来宾→宾客
宾朋盈门→宾客盈门
三千珠履→宾客盈庭
宾朋盈门→宾朋迎门
宾朋迎门→宾朋盈门
摈弃→摈斥
驱逐→摈除
屏弃→摈弃
光风霁月→冰壶秋月
酷寒→冰冷
冷面→冰脸
龙脑→冰片
不染纤尘→冰清玉洁
水火不容→冰炭不洽
雪窖冰天→冰天雪地
叛乱→兵变
师出无名→兵出无名
军多将广→兵多将广
兵书→兵法
打仗→兵戈
艨艟→兵舰
军力→兵力
戎马→兵马
战士→兵士
兵法→兵书
佳兵不祥→兵凶战危
虎帐→兵营
军种→兵种
承袭→秉承
而且→并且
草衣木食→并日而食
独一无二→并世无双
霸占→并吞
垂死→病笃
祸国殃民→病国殃民
全愈→病愈
医院→病院
货郎鼓→拨浪鼓
盘弄→拨弄
颠簸→波动
汹涌澎湃→波澜壮阔
海浪→波浪
妨害→波折
褫夺→剥夺
否极必泰→剥极必复
聚敛→剥削
吸血虫→剥削者
昆季→伯仲
驳倒→驳斥
驳斥→驳倒
非难→驳诘
靠岸→泊岸
停车→泊车
怫然作色→勃然变色
来路货→舶来品
泛爱→博爱
博学多闻→博古通今
展览会→博览会
广博→博识
宏儒硕学→博学多才
博古通今→博学多闻
屠杀→搏斗
拚命→搏命
苦命→薄命
软弱→薄弱虚弱
菲酌→薄酌
赔偿→补偿
调停→补救
修缮→补葺
修理→补缀
疑神疑鬼→捕风捉影
捕捉→捕获
探员→捕快
网鱼→捕鱼
不安分→不安本分
不安本分→不安分
不守妇道→不安于室
不守妇道→不安于位
未便→不便
稳定→不变
鄙人→不才
不理→不睬
意外→不测
不可→不成
不长进→不成才
不长进→不成材
有失体统→不成体统
不食人间烟火→不吃烟火食
从容不迫→不迟不疾
不辞劳怨→不辞劳苦
不辞劳苦→不辞劳怨
不搭嘴→不搭腔
不搭腔→不搭嘴
不合时宜→不达时宜
不搭腔→不答腔
不打不相识→不打不成相识
不打不相识→不打不成相与
不打不成相与→不打不相识
不但→不单
不光→不但
不妥→不当
不作数→不当准
天诛地灭→不得善终
茫无头绪→不得要领
不停→不断
精益求精→不断改进
未几→不多
不违农时→不夺农时
不贰→不二
铁价→不二价
不二→不贰
不胜枚举→不乏其人
非法→不法
非凡→不凡
没关系→不妨
没关系→不妨事
轻视→不放在眼里
难分轩轾→不分高下
不顾曲直→不分皁白
不够→不敷
不顺手→不伏手
不服水土→不伏水土
不平→不服
水土不服→不服水土
不应→不该
吞声忍气→不敢则声
你死我活→不共戴天
道貌岸然→不苟言笑
不敷→不够
未入流→不够格
掉臂→不顾
不分皁白→不顾曲直
不拘小节→不顾外表
悍然不顾→不顾一切
不但→不光
小心翼翼→不寒而栗
欠好→不好
分歧→不合
不对→不合错误
不达时宜→不合时宜
反面→不和
半推半就→不即不离
不可胜数→不计其数
欠安→不佳
不露锋芒→不见圭角
不断→不竭
不但→不仅
风行一时→不胫而走
未几→不久不多
不顾外表→不拘小节
未定→不决
不停→不绝
不易之论→不刊之论
不胜→不堪
不行→不可
多如牛毛→不可偻指算
不计其数→不可胜数
难以想象→不可思议
咄咄逼人→不可一世
不能→不克不及
不愿→不肯
烦懑→不快
不稂不莠→不郎不秀
不郎不秀→不稂不莠
坐享其成→不劳而获
不睬→不理
倒霉→不利
不意→不料
不惜→不吝
不吝指教→不吝金玉
不吝珠玉→不吝指教
不吝指教→不吝珠玉
不留心→不留神
不留神→不留心
杀鸡取卵→不留余地
不见圭角→不露锋芒
不露锋芒→不露圭角
不露声色→不露神色
不露神色→不露声色
稳定→不乱
不正经→不伦不类
岂论→不论
不落俗套→不落窠臼
不落窠臼→不落俗套
难免→不免
未免→不免难免
不约而合→不谋而合
不克不及→不能
不能胜数→不能尽数
不能尽数→不能胜数
欲罢不能→不能自休
不能自制→不能自已
不能自已→不能自制
不宁奈→不宁不奈
不宁耐→不宁不耐
不宁不奈→不宁奈
不宁不耐→不宁耐
数奇→不偶
中庸之道→不偏不倚
不屈→不平
萍水相逢→不期而遇
生吞活剥→不求甚解
不平→不屈
奋不顾身→不屈不挠
否则→不然
冰清玉洁→不染纤尘
克日→不日
幸不辱命→不辱使命
不中听→不入耳
不伦不类→不三不四
惠而不费→不伤脾胃
处境尴尬→不上不下
失慎→不慎
不堪→不胜
昏迷不醒→不省人事
时时→不时
不识时务→不识时变
不识之无→不识一丁
不吃烟火食→不食人间烟火
不安于室→不守妇道
不伏手→不顺手
非死即伤→不死即伤
不绝→不停
欠亨→不通
差别→不同
与众不同→不同凡响
不当→不妥
不过→不外
有良心→不忘本
不夺农时→不违农时
不惟→不唯
不唯→不惟
吊儿郎当→不务正业
不断→不息
不吝→不惜
平分秋色→不相上下
断绝往来→不相闻问
不用→不消
不可→不行
不断→不休
囚首垢面→不修边幅
生而知之→不学而能
观→不雅
不雅→不雅观
不问可知→不言而喻
不厌求详→不厌其详
不厌其详→不厌求详
没关系→不要紧
纷歧→不一
天经地义→不移至理
尽心尽力→不遗余力
漫不经心→不以为意
相同→不异
不刊之论→不易之论
不料→不意
不知去向→不翼而飞
不该→不应
不消→不用
毋须着急→不用着急
忍不住→不由得
不料→不虞
不肯→不愿
不谋而合→不约而合
不谋而合→不约而同
永远贬抑→不再任用
未曾→不曾
不伦不类→不正经
过河拆桥→不知恩义
何足道哉→不值一提
不但→不只
不入耳→不中听
禁绝→不准
天南地北→不着边际
蚍蜉撼树→不自量力
不敷→不足
不足挂齿→不足齿数
不足齿数→不足挂齿
无足挂齿→不足介意
不足为凭→不足为据
不足为据→不足为凭
屡见不鲜→不足为奇
不当准→不作数
不当准→不作准
拂尘→布掸子
传教→布道
通告→布告
班门弄斧→布鼓雷门
背景→布景
结构→布局
排列→布列
布疋→布匹
救济→布施
布匹→布疋
平民→布衣
贫贱交→布衣交
布衣蔬食→布衣粝食
布衣粝食→布衣蔬食
微时之交→布衣之交
排阵→布阵
部署→布置
步卒→步兵
稳扎稳打→步步为营
阵势→步地
步骤→步调
队伍→步队
步调→步伐
行动→步履
步碾儿→步辇儿
步辇儿→步碾儿
追随骥尾→步人后尘
步辇儿→步行
步调→步骤
步兵→步卒
队伍→部队
部分→部门
摆设→部署
部属→部下
下属→部属
本子→簿本
本子→簿子
怒目→瞋目
捋臂张拳→擦拳磨掌
捋臂张拳→擦拳抹掌
捋臂张拳→擦掌摩拳
捋臂张拳→擦掌磨拳
推测→猜测
推测→猜度
豁拳→猜拳
困惑→猜疑
料中→猜中
学富五车→才当曹斗
才华→才调
本领→才干
学富五车→才高八斗
目空一切→才高气傲
才气→才华
本领→才具
本领→才力
本领→才略
才气→才能
才华→才气
天才横溢→才气纵横
才思→才情
秀士→才人
才情→才思
本领→才智
本领→材干
材艺→材伎
质料→材料
材伎→材艺
玉帛→财宝
钱财→财帛
产业→财产
财产→财富
财货→财贿
财贿→财货
财源→财路
见利忘义→财迷心窍
财运→财气
财政→财务
财路→财源
财气→财运
财务→财政
富翁→财主
撤消→裁撤
酌定→裁夺
成衣→裁缝
淘汰→裁减
评判员→裁判员
裁员→裁人
淘汰→裁汰
裁人→裁员
购买→采办
收罗→采集
采取→采纳
接纳→采取
挑撰→采选
接纳→采用
访拿→踩缉
践踏→踩踏
蹂躏踹踏→踩踏辚轹
各半→参半
乱七八糟→参差不齐
观光→参观
到场→参加
拜见→参见
他山之石→参考之资
商讨→参议
到场→参与
到场→参预
披星带月→餐风宿露
披星带月→餐风宿雨
披星带月→餐风饮露
暴虐→残暴
残余→残存
冷炙→残羹
践踏糟踏→残害
暴虐→残酷
凋零→残落
肆虐→残虐
残缺→残破
残破→残缺
暴虐→残忍
屠杀→残杀
半壁江山→残山剩水
剩余→残剩
渣滓→残余
冷炙→残
内疚→惭愧
苍白→惨白
惨恻→惨怆
昏暗→惨淡
暴虐→惨酷
暗澹→惨然
凄惨→惨痛
天昏地暗→惨无天日
辉煌光耀→灿烂
绚丽→灿艳
匆匆→仓促
急忙→仓猝
堆栈→仓库
急忙→仓卒
祸乱滔天→沧海横流
白云苍狗→沧海桑田
太仓一粟→沧海微尘
九牛一毛→沧海一粟
惨白→苍白
葱翠→苍翠
迷茫→苍茫
百姓→苍生
彼苍→苍天
厮役→苍头
埋没→藏匿
立足→藏身
存身→藏身安身
图书馆→藏书楼
练习→操练
抚琴→操琴
练习→操演
利用→操纵
操纵→操作
驾驭→操作把持
初创→草创
底稿→草稿
滥杀无辜→草菅人命
马虎→草率
草泽→草莽
凉帽→草帽
牛山濯濯→草木不生
杯弓蛇影→草木皆兵
惊弓之鸟→草木惊心
起草→草拟
喽啰→草头神
茅舍→草屋
芒鞋→草鞋
草泽→草野
并日而食→草衣木食
草野→草泽
厕纸→草纸
书籍→册本
封爵→册封
书页→册页
侧艳→侧丽
侧丽→侧艳
偏重→侧重
茅厕→厕所
草纸→厕纸
揣测→测度
丈量→测量
尝试→测验考试
拆字→测字
发动→策动
筹谋→策划
盘算→策画
计谋→策略
接应→策应
屡见不鲜→层出不穷
条理→层次
井井有条→层次分明
不足为奇→层见迭出
井井有条→层序分明
加入→插手
加入→插足
核办→查办
检察→查察
检查→查抄
核对→查对
考核→查核
核办→查究
检察→查看
覆按→查考
盘问→查问
盘问→查询
调查→查询拜访
检验→查验
跑堂→茶房
茶室→茶馆
谈话会→茶话会
茶室→茶楼
墨绿→茶青
茶楼→茶室
茶楼→茶肆
鉴貌辨色→察言观色
歧路→岔路
歧路→岔路支路
惊奇→诧异
不对→差池
不对→差错
低劣→差劲
驱使→差遣
警察→差人
完场→拆档
散伙→拆伙
捣乱→拆台
披览→拆阅
测字→拆字
木炭→柴炭
虎豹→豺狼
扶持→搀扶
扶助→搀扶帮助
拌合→搀合
拌合→搀和
陷害→谗谄
诽语→谗言
垂涎欲滴→馋涎欲滴
贪嘴→馋嘴
牵累→缠累
缱绻→缠绵
裹足→缠足
连任→蝉联
产物→产品
孕育发生→产生
产品→产物
财产→产业
拔除→铲除
分析→阐发
分析→阐明
发挥→阐扬
轰动→颤动
哆嗦→颤抖
发抖→颤栗
盛大→昌大
兴盛→昌隆
兴盛→昌盛
放肆→猖獗
放肆→猖狂
尊长→长辈
是非→长短
犬牙交错→长短不一
鹘程万里→长风万里
主座→长官
上进→长进
恒久→长久
漫空→长空
长逝→长眠
长寿→长命
天保九如→长命百岁
恒久→长期
蛇矛→长枪
势如破竹→长驱直入
永日→长日
永生→长生
天保九如→长生不老
永劫→长时
长眠→长逝
长命→长寿
浩叹→长叹
远程→长途
多财善贾→长袖善舞
永夜→长夜
老小→长幼
善于→长于
浩叹→长吁
对天长叹→长吁短叹
久远→长远
父老→长者
宗子→长子
试试→尝尝
见微知着→尝鼎一脔
一叶知秋→尝鼎一
实验→尝试
归还→偿还
枕戈待旦→常备不懈
每每→常常
通例→常规
老例→常例
凡人→常人
平日→常日
知识→常识
园地→场地
局面→场合排场
局面→场面
局势→场面地步
洞开→敞开
明亮→敞亮
通畅→畅达
开怀→畅怀
痛快酣畅→畅快
各抒己见→畅所欲言
泛论→畅谈
流通→畅通
融会→畅通领悟
流通→畅通流畅
无阻畅通→畅通无阻
兴旺→畅旺
脱销→畅销
舒怀→畅意
痛饮→畅饮
妓院→倡寮
提倡→倡始
发起→倡议
曲稿→唱本
手本→抄本
缮写→抄录
搜劫→抄掠
誊录→抄写
誊写→钞缮
誊录→钞写
凌驾→超出
高出→超出跨越
超级→超等
逾额→超额
卓荦不群→超凡入圣
凌驾→超过
高出→超过跨过
超等→超级
卓荦不群→超绝群伦
轶群→超群
超群绝伦→超群出众
超群出众→超群绝伦
逸群绝俗→超群脱俗
飘逸→超脱
飘逸→超逸
逾越→超越
出色→超卓
唇亡齿寒→巢毁卵破
穴居野处→巢木居野
唇亡齿寒→巢倾卵破
岌岌可危→朝不保夕
岌岌可危→朝不虑夕
清早→朝晨
朝梁暮晋→朝梁暮陈
朝梁暮陈→朝梁暮晋
生机→朝气
生机勃勃→朝气蓬勃
朝三暮四→朝秦暮楚
朝秦暮楚→朝三暮四
进取→朝上进步
反复无常→朝四暮三
旦夕→朝夕
早霞→朝霞
讽刺→嘲讽
揶揄→嘲弄
讽刺→嘲笑
戏弄→嘲谑
潮水→潮流
湿润→潮湿
潮流→潮水
打骂→吵架
交谪→吵骂
喧华→吵闹
烦吵→吵杂
口角→吵嘴
卷铺盖→炒鱿鱼
车资→车费
倾盖论交→车笠之盟
门庭若市→车水马龙
满坑满谷→车载斗量
车费→车资
说谎→扯谎
撕裂→扯破
胡诌→扯谈
透骨→彻骨
彻上彻下→彻里彻外
彻里彻外→彻上彻下
彻里彻外→彻头彻尾
通宵→彻夜
撤消→撤除
废除→撤废
后退→撤退退却
撤除→撤消
打消→撤销
革职→撤职
透澈→澈底
大澈大悟→澈底觉悟
砭骨→澈骨
灰尘→尘埃
红尘→尘凡
凡间→尘寰
凡间→尘间
凡间→尘世
尘务→尘事
灰尘→尘土
尘事→尘务
寂静→沉寂
沉醉→沉浸
平静→沉静
重病→沉痾
迷恋→沉沦
埋没→沉没
烦闷→沉闷
着迷→沉迷
沉溺→沉湎
迷恋→沉溺
沦落→沉溺堕落
甜睡→沉睡
覃思→沉思
悲痛→沉痛
闭月羞花→沉鱼落雁
极重繁重→沉重
沉痾→沉
抱残守缺→陈陈相因
痕迹→陈迹
千篇一律→陈旧见解
腐朽→陈旧迂腐
管鲍之交→陈雷之契
陈设→陈列
展览场→陈列所
八股→陈腔滥调
报告→陈述
报告→陈说
报告→陈诉
旧帐→陈帐
早安→晨安
晓风→晨风
旦夕→晨夕
肇事→闯祸
突入→闯入
肇事→闯事
渲染→衬着
歌颂→称道
称王称帝→称孤道寡
称呼→称号
称谓→称呼
托病→称疾
合身→称身
歌颂→称颂
称孤道寡→称王称帝
称呼→称谓
致谢→称谢
快意→称心
遂心如愿→称心快意
心满意足→称心满意
得偿所愿→称心如意
歌颂→称扬
歌颂→称誉
歌颂→称赞
顺便→趁便
随波逐流→趁波逐浪
看风使舵→趁风扬帆
攻其不备→趁火打劫
乘隙→趁机
一气呵成→趁热打铁
赶早→趁早
充排场→撑场面
支持→撑持
本钱→成本
发展→成长
构怨→成仇
身分→成分
乐成→成功
结婚→成婚
结果→成绩
立室→成家
克绍箕裘→成家立业
建立→成立
老例→成例
登龙术→成名术
制品→成品
结婚→成亲
玉成→成全
三五成群→成群结队
杀身成仁→成仁取义
谋事在人→成事在人
整天→成天
羽化→成仙
结果→成效
裁缝→成衣
针言→成语
匠意于心→成竹在胸
报告→呈报
报告→呈文
包办→承办
负担→承担
负担→承当
承袭→承继
答应→承诺
太平→承平
承先启后→承前启后
领情→承情
认可→承认
承先启后→承上启下
承继→承袭
承上启下→承先启后
诚实→诚笃
坐卧不宁→诚惶诚恐
老实→诚恳
诚笃→诚实
恳切→诚心
全心全意→诚心诚意
至心→诚意
金吾不禁→城开不夜
都会→城市
搭车→乘车
搭船→乘船
搭客→乘客
纳凉→乘凉
攻其不备→乘人之危
趁机→乘隙
攻其不备→乘虚而入
惩办→惩处
劝善→惩恶
处罚→惩罚
尊师重道→程门立雪
步伐→程序
饮茶→吃茶品茗
妒忌→吃醋
服法→吃法
用饭→吃饭
急急→吃紧
罗掘俱穷→吃尽当光
受惊→吃惊
刻苦→吃苦
忍苦→吃苦俭朴
亏损→吃亏
费力→吃力
劳而无功→吃力不讨好
不识时务→吃米不知米价
食斋→吃素
迟钝→痴钝
臃肿→痴肥
白痴→痴人
愚钝→痴顽
胡思乱想→痴心妄想
开禁→弛禁
减刑→弛刑
无妄之灾→池鱼之殃
沼泽→池沼
着名→驰名
想念→驰念
奔走→驰驱
呆笨→迟笨
耽误→迟误
拖延→迟延
当机不断→迟疑不决
早晚→迟早
长期→持久
尸位素餐→持禄
平心而谈→持平立论
持疑不决→持疑不定
持疑不定→持疑不决
始终如一→持之以恒
庄重→持重
函牍→尺牍
掌上河山→尺幅千里
函牍→尺简
函牍→尺书
函牍→尺素
老态龙钟→齿豁头童
羞耻→耻辱
讥笑→耻笑
开辟→斥地
革退→斥革
尖兵→斥候
诃斥→斥骂
革退→斥退
求全谴责→斥责
遣散→斥逐
羞辱→赤诚
披肝沥胆→赤诚相见
忠心耿耿→赤胆忠心
百孔千疮→赤地千里
光脚→赤脚
红军→赤军
血色→赤色
裸体→赤身
袒裼裸裎→赤身露体
白手→赤手
手无寸铁→赤手空拳
至心→赤心
忠肝义胆→赤血丹心
小儿百姓→赤子
酷热→炽烈
酷热→炽热
党羽→翅膀
满盈→充斥
置之不理→充耳不闻
充实→充分
没收→充公
果腹→充饥
满盈→充满
撑场面→充排场
充足→充沛
满盈→充塞
充分→充实
凑数→充数
充斥→充溢
丰裕→充盈
充分→充裕
富足→充足
冒犯→冲犯
赴汤蹈火→冲锋陷阵
打击→冲击
冒犯→冲克
洗沐→冲凉
突破→冲破
突入→冲入
稚子→冲弱
辩论→冲突
要冲→冲要
冒犯→冲撞
蜩螗沸羹→虫鸣水沸
昆虫→虫豸
雕虫小技→虫篆之技
信仰→崇奉
高贵→崇高
高超→崇高高贵
痛爱→宠爱
溺爱→宠嬖
骄子→宠儿
爱妾→宠姬
宠信→宠任
生杀与夺→宠辱祸福
宠任→宠信
厚待→宠遇
剥削→抽剥
打秋风→抽丰
抽闲→抽空
哭泣→抽泣
抽空→抽暇
抽空→抽闲
发芽→抽芽
吸烟→抽烟
敌人→仇敌
愤恨→仇恨
对头→仇家
对头→仇人
中怀怨恨→仇隙在心
缱绻→绸缪
从前→畴前
曩昔→畴昔
满腹忧愁→愁肠百结
哀肠百转→愁肠寸断
愁云满面→愁眉不展
没精打彩→愁眉苦脸
愁眉苦脸→愁眉锁眼
烦闷→愁闷
愁眉不展→愁云满面
浓厚→稠密
大庭广众→稠人广众
混杂→稠浊
准备→筹办
张罗→筹措
策划→筹谋
筹议→筹商
打算→筹算
商量→筹议
报答→酬报
寒暄→酬酢
报答→酬金
报酬→酬劳
报答→酬谢
犹豫→踌躇
意得志满→踌躇满志
貌寝→丑陋
污名→臭名
声名狼藉→臭名远扬
臭名远扬→臭名昭着
出书→出版
发兵→出兵
生产→出产
进场→出场
来由→出处
堕落→出错
召盘→出顶
于归之喜→出阁之喜
特别→出格
乔迁之喜→出谷迁乔
着力→出力
特别卖力→出力异常
露马脚→出漏洞
神出鬼没→出没无常
行踪飘忽→出没无定
着名→出名
出谋献策→出谋划策
出谋划策→出谋献策
声东击西→出奇制胜
有缺→出缺
出人意料→出人意表
出人意表→出人意料
收支→出入
跬步不离→出入相随
身世→出身
入迷→出神
出世→出生避世
作声→出声
失事→出事
脱手→出手
出版→出书
出面→出头具名
避难→出亡
前程→出息
脱险→出险
一言九鼎→出言如山
恶语伤人→出言无状
放洋→出洋
必不得已→出于无奈
开端→初步
首创→初创
早春→初春
首次→初次
初次→初度
底稿→初稿
低级→初级
开端→初阶
月朔→初一
眉月→初月
初衷→初志
初志→初衷
撤除→除掉
锄奸→除奸
革故鼎新→除旧更新
革职→除名
撤除→除去
荡瑕涤秽→除污去垢
大年夜→除夜
庖丁→厨子
除奸→锄奸
振弱除暴→锄强扶弱
储备→储蓄
积储→储蓄储存
积聚→储蓄积累
我见犹怜→楚楚可怜
悲凄→楚切
笞打→楚挞
到处→处处
不上不下→处境尴尬
处置惩罚→处理
童贞→处女
办事→处事
正法→处死
费尽心血→处心积虑
处理→处置惩罚
冒犯→触犯
举一反三→触类旁通
比比皆是→触目皆是
惹恼→触怒
臆测→揣测
推断→揣度
推断→揣摸
推测→揣摩
悬想→揣想
络绎不绝→川流不息
盘缠→川资
穿着→穿戴
穿房入户→穿房过屋
穿房过屋→穿房入户
宣称→传播鼓吹
通报→传递
列传→传记
布道→传教
感染→传染
流行症→传染病
感化→传染感动
逼真→传神
教授→传授
传闻→传说风闻
歌颂→传颂
听说→传闻
外扬→传扬
翻译员→传译员
码头→船埠
船主→船长
船坞→船厂
舟子→船夫
水费→船脚
甲板→船面
船厂→船坞
海员→船员
船长→船主
喘息→喘气
喘气→喘息
勾通→串连
勾通→串通
百孔千疮→疮痍满目
迭床架屋→床上安床
囊空如洗→床头金尽
枕席→床笫
建立→创立
建立→创设
首创→创始
百孔千疮→创痍满目
发起→创议
缔造→创作发明
奏乐→吹打
吹牛→吹法螺
沿门托钵→吹箫吴市
演奏→吹奏
烟火→炊火
膳食→炊事
渐渐→垂垂
钓鱼→垂钓
老迈→垂老
怜爱→垂怜
钓鱼→垂纶
看重→垂青
轻而易举→垂手可得
弥留→垂死
低头→垂头
告急→垂危
顾问→垂问
照拂→垂问咨询人
馋涎欲滴→垂涎欲滴
流芳百世→垂馨千祀
东风→春风
秘戏图→春宫
月下花前→春花秋月
春光→春景
春光→春景春色
对联→春联
南柯一梦→春梦一场
春心→春情
年龄→春秋
春情→春心
老练→纯熟
单纯→纯真
纯洁→纯正
朱唇皓齿→唇红齿白
费尽唇舌→唇焦舌敝
巢毁卵破→唇亡齿寒
摩拳擦掌→蠢蠢欲动
笨伯→蠢人
外号→绰号
词藻→词采
辞书→词典
词章→词翰
词藻→词华
文句→词句
似义词→词目
刀笔→词讼
词采→词藻
词翰→词章
好生之德→慈悲心肠
善士→慈善家
乌鸟私情→慈乌反哺
告别→辞别
谈锋→辞令
推辞→辞让
词典→辞书
谈吐→辞吐
推却→辞谢
告别→辞行
文意→辞意
告老还乡→辞职归里
牝牡→雌雄
这次→此次
欲盖弥彰→此地无银三百两
今后→此后
现在→此刻
这天→此日
今生→此生
别的→此外
其中→此中
局内人→此中人
序次→次第
劣货→次货
越日→次日
序次→次序
次第→次序递次
砭骨→刺骨
刺眼→刺目
刺眼→刺目耀眼
密查→刺探
光顾→赐顾
照顾→赐顾帮衬
见教→赐教
赐予→赐赉
给予→赐与
斧正→赐正
今后→从此
古往今来→从古到今
服从→从命
当兵→从戎
从容自在→从容自若
从容自若→从容自在
赶快→从速
重新→从头
从头至尾→从头到尾
从头到尾→从头至尾
重新→从新
堂兄弟→从兄弟
急忙→匆匆
急忙→匆促
仓卒→匆急
苍翠→葱翠
胡涂一时→聪明一世
聪明一世→聪明一世，胡涂一时
聪明一世→聪明一世，懵懂一时
猬集→丛集
簇集→丛聚
森林→丛林
拼集→凑合
巴结→凑趣
奉迎→凑趣儿
充数→凑数
碌碌无为→凑数其间
大略→粗略
卤莽→粗莽
贱躯→粗躯
卑鄙→粗俗
鄙言→粗言
恶衣恶食→粗衣劣食
粗糙→粗拙
把臂而谈→促膝谈心
丛聚→簇集
窜扰→窜犯
潜伏→窜伏
篡改→窜改
逃匿→窜匿
窜犯→窜扰
敦促→催促
追讨→催讨
糟蹋→摧残浪费蹂躏
折辱→摧辱
华而不实→脆而不坚
青翠→翠绿
珠光宝气→翠绕珠围
乡人→村夫
牧歌→村歌
乡村→村落
村学→村塾
村学→村校
村塾→村学
乡村→村庄
村落→村子
备案→存案
请安→存候
关注→存眷
立足→存身
生死→存亡
请安→存问
包藏祸心→存心不良
跬步不离→寸步不离
无法动弹→寸步难移
鸡犬不留→寸草不留
寸阴→寸晷
一男半女→寸男尺女
袒裼裸裎→寸丝不挂
寸衷→寸心
寸晷→寸阴
寸心→寸衷
微暇→寸
商量→磋议
拉拢→撮合
月老祠→撮合山
提要→撮要
折辱→挫辱
波折→挫折
说话→措辞
步伐→措施
处置→措置
谬爱→错爱
惊惶→错愕
庞杂→错乱
犬牙交错→错落有致
缺点→错误谬误
庞杂→错杂
乘车→搭车
乘船→搭船
摆架子→搭架子
援救→搭救
旅客→搭客
铰链→搭钮
告竣→达成
王侯将相→达官贵人
回复→答复
答应→答理
报答→答谢
复书→答信
答应→答允
装束→打扮服装
恐吓→打单
打垮→打倒
办理→打点
盘算→打定
拿定主意→打定主意
感动→打动
打架→打斗
赌钱→打赌
瞌睡→打盹
瞌睡→打盹儿
丁宁→打发
击柝→打更
讥笑→打诨
闹饥荒→打饥荒
打斗→打架
掠夺→打劫
打倒→打垮
审察→打量
狩猎→打猎
吵架→打骂
拍门→打门
冲破→打破
抽丰→打秋风
玩笑→打趣
打搅→打扰
打手势→打手式
打手式→打手势
汲水→打水
打顺风旗→打顺风锣
打顺风锣→打顺风旗
人工流产→打胎
探询探望→打听
取消→打消
递眼色→打眼号
捕鱼→打鱼
注射→打针
明白→大白
大北→大败
买办→大班
泰半→大半
大败→大北
斗篷→大氅
澈底觉悟→大澈大悟
大言不惭→大吹牛皮
暴徒→大盗
盛德→大德
大略→大抵
多数→大都
漂亮→大度
医生→大夫
豪富→大富
大略→大概马虎
年老→大哥
至公→大公
大公无私→大公至正
大呼→大喊
大喊→大呼
谎话→大话
各人→大家
台端→大驾
巨猾→大奸
上将→大将
大呼→大叫
猛进→大进
大肆→大举
雄师→大军
seo→搜索引擎优化
民怨沸腾→大快人心
燕尾服→大礼服
鼎力大举→大力
鼎力玉成→大力成全
大抵→大略
大刀阔斧→大马金刀
痛骂→大骂
台甫→大名
浩劫→大难
劫后余生→大难不死
犯上作乱→大逆不道
除夕→大年节
年夜→大年夜
震怒→大怒
大权独揽→大权在握
焚琴煮鹤→大煞风景
高声→大声
大家→大师
局势→大势
洪流→大水
放肆→大肆
怒不可遏→大肆咆哮
大要→大体
稠人广众→大庭广众
巨细→大小
泰山其颓→大星殒落
风雅→大雅
狂言→大言
喋不休→大言不惭
大概→大要
大雨如注→大雨滂沱
大雨滂沱→大雨如注
约莫→大约
剧盗→大贼
宝缄→大札
大吹牛皮→大张其词
主旨→大旨
雄心→大志
大抵→大致
普通化→大众化
民间文学→大众文学
籀文→大篆
富家→大族
烂醉陶醉→大醉
目瞪口呆→呆头呆脑
白痴→呆子
恶人得势→歹徒横行
代庖→代办
代理→代办署理
价钱→代价
代庖→代劳
代劳→代庖
动员→带动
连累→带累
领导→带领
携同→带同
披星带月→带月披星
囤积居奇→待价而沽
报酬→待遇
疲惫→怠倦
怠惰→怠懈
感德→戴德
披星带月→戴月披星
披肝沥胆→丹成相许
肝胆相照→丹诚相许
方剂→丹方
图画→丹青
美术大师→丹青妙手
赤心→丹心
单人独马→单刀赴会
片面→单方面
票据→单据
单刀赴会→单人独马
只身→单身
单元→单位
单位→单元
票据→单子
包管→担保
继承→担当
耽搁→担搁
担当→担任
挑水→担水
迷恋→耽溺
延长→耽误
耽搁→耽延
胆大心小→胆大心细
胆大心细→胆大心小
胆怯→胆寒
胆子→胆量
心胆俱寒→胆破心惊
提心吊胆→胆战心惊
胆量→胆子
花旦→旦角
朝夕→旦夕
希望→但愿
奏琴→弹琴
一矢之地→弹丸之地
百步穿杨→弹无虚发
转瞬之间→弹指之间
浅色→淡色
卵白→蛋白
投军→当兵
就地→当场
今世→当代
本地→当地
举棋不定→当机不断
立即→当即
方丈和尚→当家和尚
政府→当局
适时→当令
劈面→当面
失之交臂→当面错过
寺库→当铺
固然→当然
其时→当时
本事儿→当事者
当头一棒→当头棒喝
当头棒喝→当头一棒
长驱直入→当者披靡
认真→当真
看成→当作
党首→党魁
党魁→党首
伐毛洗髓→荡垢涤污
勾魂摄魄→荡气回肠
划船→荡舟
浪子→荡子
檀案→档册
词讼→刀笔
兵器→刀兵
单刀直入→刀刀见血
刀光血影→刀光剑影
刀光剑影→刀光血影
死生无惧→刀锯不辞
刀口上舔血→刀头舔血
佛口蛇心→刀头之蜜
引火线→导火线
扶引→导引
滚瓜烂熟→倒背如流
背叛→倒戈
颠三倒四→倒横直竖
扫径以待→倒履相迎
却是→倒是
坍毁→倒塌
凋零→倒退腐败
反照→倒映
颠倒→倒置
作怪→捣蛋
祈祷→祷告
奋发图强→蹈厉奋发
赴任→到差
加入→到场
随处→到处
东奔西走→到处奔跑
跋山涉水→到处奔走
脍炙人口→到处颂扬
浪迹江湖→到处为家
抵家→到家
来临→到临
得手→到手
哀悼→悼念
伏莽→盗匪
冷汗→盗汗
山寨→盗窟
盗首→盗魁
偷窃→盗窃
偷取→盗取
盗魁→盗首
地方不宁→盗贼四起
作别→道别
品德→道德
庆贺→道贺
玄门→道教
原理→道理
门路→道路
致歉→道歉
羽士→道士
耳食之闻→道听涂说
致谢→道谢
方巾气→道学味
衣食计→稻粱谋
抱病→得病
心满意足→得偿所愿
恰当→得当
解围→得救
冒犯→得罪
电话→德律风
元配→德配
宽猛相济→德威并用
品德→德行
德行→德性
确当→的当
简直→的确
丁一卯二→的一确二
灯泡→灯胆
旗号→灯号
灯烛辉煌→灯火辉煌
字谜→灯谜
灯胆→灯泡
灯炷→灯芯
灯芯→灯炷
登陆→登岸
至高无上→登峰造极
振臂一呼→登高一呼
登位→登基
录取→登科
成名术→登龙术
登岸→登陆
爬山→登山
立地→登时
尸解→登仙
刊登→登载
比及→等到
品级→等第
平分→等分
期待→等候
品级→等级
轻易→等闲
即是→等于
石崇之富→邓通之财
怒视→瞪眼
克己→低廉甜头
低沉→低落
窃窃私议→低声密谈
交头接耳→低声密语
低首下心→低头屈膝
点水不漏→滴水不漏
淌下→滴下
仇人→敌人
对手→敌手
嫡系→嫡派
发妻→嫡妻
天伦→嫡亲
稿本→底稿
本相→底细
秘闻→底蕴
根本→底子
补偿→抵偿
冲撞→抵触触犯
抵抗→抵当
反抗→抵挡
到家→抵家
反抗→抵拒
狡辩→抵赖
抵抗→抵制
隧道→地道
所在→地点
地震→地动
盗贼四起→地方不宁
父母官→地方官
白蜡→地蜡
人地相宜→地利人和
人杰地灵→地灵人杰
土地→地盘
地盘→地皮
流氓→地痞
方单→地契
阵势→地势
舆图→地图
职位地方→地位
地理→地舆
地动→地震
地点→地址
舆志→地志
田主→地主
弟媳→弟妇
弟妇→弟媳
门生→弟子
顺序→递次
打眼号→递眼色
圈外人→第三者
初版→第一版
最高级→第一流
公馆→第宅
订盟→缔盟
联婚→缔姻
创造→缔造
颠三倒四→颠倒错乱
顶峰→颠峰
经过→颠末
跌倒→颠仆
范例→典范榜样
文籍→典籍
仪式→典礼
典雅堂皇→典丽矞皇
解当铺→典押铺
典丽矞皇→典雅堂皇
抵押→典质
修改→点窜
滴水不漏→点水不漏
颔首→点头
颔首应承→点头答应
粉饰→点缀
稍纵即逝→电光石火
德律风→电话
风扇→电扇
影戏→电影
田户→佃户
狩猎→佃猎
房客→佃农
铺保→店保
店主→店东
店肆→店铺
店铺→店肆
伙计→店员
东家→店主
奠基→奠定
奠定→奠基
强横→刁悍
奸滑→刁猾
蛮话→刁话
腐败→凋射
凋落→凋谢
凋零→凋谢脱落
堡垒→碉堡
凋零→雕残
虫篆之技→雕虫小技
蛮横→雕悍
镌刻→雕刻
栏杆→雕栏
雕落→雕零
雕刻→雕镂
雕零→雕落
好逸恶劳→吊儿郎当
悬挂→吊挂
吊丧→吊祭
悬梁→吊颈
除暴安良→吊民伐罪
打水→吊水
吊丧→吊问
垂纶→钓鱼
转班→调班
挑唆→调拨
观察→调查
变更→调动
调理→调度
变更→调换
集合→调集
调度→调剂
调治→调节
调停→调解排遣
讥讽→调侃
调治→调理
派遣→调派
谐谑→调笑
保养→调养
挪用→调用
调解→调整
调理→调治
音调→调子
失→掉
偷换→掉包
不顾→掉臂
落后→掉队
跌荡→跌宕
跌荡→跌宕放诞
跌宕→跌荡放诞
床上安床→迭床架屋
情报→谍报
叮咛→丁宁
的一确二→丁一卯二
父（母）丧→丁忧
壮年→丁壮
吩咐→叮咛
嘱咐→叮嘱
缝扣子→钉扣子
极点→顶点
中用→顶用
顶撞→顶嘴
大力→鼎力
大肆→鼎力大举
大力成全→鼎力玉成
壮盛→鼎盛
改革→鼎新
鼎立→鼎峙
三足鼎立→鼎足之势
国祚→鼎祚
拟订→订定
和议→订定合同
文定→订婚
定价→订价
相交→订交
缔盟→订盟
订婚→订亲
考订→订正
建都→定都
决断→定夺
定例→定规
订价→定价
意见→定见
定规→定例
命名→定名
定数→定命
订婚→定亲
分高下→定胜败
定命→定数
放心→定心
界说→定义
定章→定则
定则→定章
治罪→定罪
魂不附体→丢魂失魄
抛弃→丢弃
到处奔跑→东奔西走
半子→东床
乱七八糟→东倒西歪
店主→东家
豕突狼奔→东逃西窜
工具→东西
东瀛→东洋
东洋→东瀛
店主→东主
店主→东主店东
北风→冬风
腐儒→冬烘
蛰伏→冬眠
寒衣→冬衣
明白→懂得
转动→动弹
消息→动静
感人→动人
沁人心脾→动人肺腑
跋前踬后→动辄得咎
行动→动作
穴居→洞居
洞穴→洞窟
了如指掌→洞若观火
蓬莱仙境→洞天福地
窟窿→洞穴
明镜高悬→洞烛奸邪
国都→都城
都市→都会
富丽→都丽
毂下→都门
好看→都雅
都会→都邑
招徕→兜揽
兜销→兜售
兜售→兜销
大胆→斗胆
大胆→斗胆勇敢
北斗→斗极
比力→斗劲
争艳→斗丽
笠帽→斗笠
旷世一人→斗南一人
打斗→斗殴
大氅→斗篷
负气→斗气
小房→斗室
米珠薪贵→斗粟囊金
辩论→斗嘴
发抖→抖动
延揽兜揽→抖揽
磨砺以须→抖擞精神
蓦地→陡然
朋分→豆割
兄弟相斗→豆箕相煎
豆乳→豆浆
及笄年华→豆蔻年华
盘据→豆剖
豆浆→豆乳
芽菜→豆芽
停留→逗留
管工→督工
迫害→毒害
鸩酒→毒酒
鸩杀→毒杀
辣手→毒手
念书→读书
把持→独霸
别出心裁→独出机杼
别开生面→独具匠心
自主国→独立国
单身→独身
单身→独身只身
利益均沾→独享权益
一意孤行→独行其是
唯一→独一
独占→独有
切断→堵截
打赌→赌博
赌博→赌钱
起誓→赌咒
狂药→杜康
闭口→杜口
襟怀→肚量
器量→度量
过活→度日
涉水→渡水
真个→端的
规矩→端方
全靠→端赖
眉目→端倪
审察→端相
捧住→端住
危坐→端坐
利害→短长
弊端→短处
短命→短寿
漫笔→短文
小引→短序
短寿→短折
穷途末路→断港绝潢
清除→断根
到处为家→断梗飘萍
销魂→断魂
不相闻问→断绝往来
毕命→断命
气绝→断气
教练→锻练
熬炼→锻炼
铸造→锻造
聚集→堆积
积累→堆集
货仓→堆栈
行列步队→队列
比拟→对比
对换→对调
敷衍→对付
对调→对换
满意→对劲
春联→对联
劈面→对面
敌手→对手
长吁短叹→对天长叹
仇家→对头
工具→对象
奕棋→对奕
棋战→对弈
对付→对于
比较→对照
半数→对折
对质→对证
对证→对质
坚持→对峙
瞄准→对准
鞭策→敦促
和睦→敦睦
敦厚→敦朴
待价而沽→囤积居奇
抑扬→顿挫
跺脚→顿脚
蓦地→顿然
马上→顿时
稽首→顿首
躲避→遁藏
托词→遁词
托辞→遁辞
避难→遁迹
豹隐→遁世
多数→多半
长袖善舞→多财善贾
节外生枝→多此一举
大批→多量
何等→多么
不足为奇→多如牛毛
几多→多少
好管闲事→多事生非
艰屯之际→多事之秋
祸发齿牙→多言招悔
多难→多灾
颤抖→哆嗦
独占鳌头→夺得冠军
醒目→夺目
免职→夺职
大札→朵云
避债→躲债
哭泣→堕泪
打胎→堕胎
海员→舵手
顿脚→跺脚
谣传→讹传
错漏→讹夺
突然→俄然
以手加额→额手称庆
分外→额外
恶运→厄运
狼心狗肺→恶毒心肠
罪不容诛→恶贯满盈
无赖→恶棍
罪不容诛→恶积祸满
罪不容诛→恶积祸盈
顽疾→恶疾
相生相克→恶马恶人骑
噩梦→恶梦
泼妇→恶妻
歹徒横行→恶人得势
暴徒→恶徒
凶相→恶相
怙恶不悛→恶性难改
粗衣劣食→恶衣恶食
出言无状→恶语伤人
开玩笑→恶作剧
隐恶扬善→遏恶扬善
停止→遏制
恩怨→恩仇
恩惠→恩德
恩情→恩典
恩泽→恩惠膏泽
膏泽→恩情
威德兼施→恩威并用
德威并用→恩威并重
恩德→恩义
恩仇→恩怨
膏泽→恩泽
童谣→儿歌
后代→儿女
尔后→而后
现在→而今
并且→而且
罢了→而已
而后→尔后
钩心斗角→尔虞我诈
耳饰→耳环
线人→耳目
目染耳濡→耳染目濡
目染耳濡→耳擩目染
道听涂说→耳食之闻
以讹传讹→耳食之言
耳环→耳饰
谆谆教诲→耳提面命
妙龄少女→二八佳人
再造之恩→二天之德
仲春→二月
他心→贰心
异议→贰言
颁发→发表
兴兵→发兵
公布→发布
发达→发财
八字帖→发草帖
抖动→发抖
发轫→发端
发愤→发奋
发狂→发疯
发号令→发号布令
发号施令→发号出令
发号布令→发号令
发号令→发号施令
发回→发还
生机→发火
起火点→发火点
恐慌→发急
发财→发家
发慌→发窘
撒酒疯→发酒疯
觉察→发觉
发疯→发狂
销售→发卖
启蒙→发蒙
举事→发难
嫡妻→发妻
提倡→发起
怒发冲冠→发上指冠
发热→发烧
发作→发生发火
立誓→发誓
失笑→发笑
刊行→发行
抽芽→发芽
发奋图强→发扬蹈厉
起源→发源
生长→发展
击鼓→伐鼓
媒人→伐柯人
荡垢涤污→伐毛洗髓
斩柴→伐木
讨伐→伐罪
宝贝→法宝
刑场→法场
法式→法度
轨范→法度模范
法例→法规
纲纪→法纪
法则→法例
法律→法令
执法→法律
国法→法律王法公法
秘诀→法门
程序→法式
术数→法术
天道好还→法网恢恢
高眼→法眼
袈裟→法衣
规则→法则
办法→法子
搪瓷→珐琅
风帆→帆船
帆柱→帆竿
航海→帆海
帆柱→帆樯
帆樯→帆柱
异邦→番邦
肥皂→番笕
甘薯→番薯
排山倒海→翻江倒海
掀开→翻开
跋山涉水→翻山越岭
翻滚→翻腾
排山倒海→翻天覆地
老千→翻戏
通译员→翻译员
伧夫俗人→凡夫俗子
尘寰→凡间
通常→凡是
吵杂→烦吵
冗杂→烦复
熯→烦忙
烦闷→烦懑
腻烦→烦厌
急躁→烦躁
屏障→樊篱
牢笼→樊笼
繁荣富强→繁荣昌盛
繁荣昌盛→繁荣富强
蕃殖→繁生
尖酸刻薄→繁言吝啬
璧还→反璧
反客为主→反宾为主
变态→反常
后坐力→反冲力
阻挡→反对
反复无常→反复不定
朝三暮四→反复无常
抨击→反攻
忏悔→反悔
还击→反击
反宾为主→反客为主
天保九如→反老回童
反攻→反扑
洗净铅华→反璞归真
背叛→反水
覆水难收→反水不收
回声→反响
倒映→反照
横竖→反正
回转→反转展转
璧还→返璧
归来回头→返来
回销→返梢
出错→犯错
犯得着→犯得上
犯得上→犯得着
犯得着→犯的上
犯忌→犯讳
犯讳→犯忌
违禁→犯禁
不法→犯警
入寇→犯境
不法→犯科
监犯→犯人
博爱→泛爱
广大→泛博
荡漾→泛动
平常→泛泛
总论→泛论
出现→泛起
饭馆→饭店
饭店→饭馆
饭店→饭铺
脓包→饭桶
引车卖浆→贩夫走卒
市井→贩子
刚刚→方才
弹丸之地→方寸之地
地契→方单
要领→方法
方子→方剂
道学味→方巾气
抗命→方命
水火不容→方枘圆凿
术士→方士
偏向→方向
方兴未艾→方兴日盛
周遭→方圆
住持僧人→方丈和尚
目标→方针
方剂→方子
青春→芳华
芗泽→芳泽
防线→防地
防地→防线
防备→防止
波折→妨害
宅券→房契
租金→房钱
衡宇→房屋
房东→房主
屋子→房子
说明书→仿单
好像→仿佛
模仿→仿照
仍旧→仿照照旧
探寻胜迹→访古寻幽
拜望→访候
缉捕→访拿
拜候→访谒
探友→访友
放手→放胆
纵脱→放荡
放荡不羁→放荡任气
纵火→放火
养虎遗患→放龙入海
巡查→放哨
放荡→放肆放任
胡天胡地→放肆荒唐
改邪归正→放下屠刀
海阔天空→放言高论
安排→放置
充军→放逐
平地一声雷→飞必冲天
风言风语→飞短流长
高潮→飞腾
飞翔→飞舞
奔腾→飞跃
格外→非分特别
不论→非论
横死→非命
不死即伤→非死即伤
微薄→菲薄单薄
菲仪→菲敬
胶卷→菲林
薄酌→菲酌
肥沃→肥饶
沃田→肥田
胰子→肥皂
土匪→匪贼
谗言→诽语
人云亦云→吠形吠声
拾人牙慧→吠影吠声
败坏→废弛
空话→废话
废物→废料
滚水→沸水
舌敝唇焦→费尽唇舌
久有存心→费尽心机
煞费苦心→费尽心血
用度→费用
分别辨别→分辨差别
分辨差别→分别辨别
分派→分拨
漫衍→分布
分家→分炊
分家→分爨
分管→分担
定胜败→分高下
支解→分割
分开→分隔
分开→分隔隔离分散
分担→分管
一点不错→分毫不爽
分解→分化
散伙→分伙
分居→分家
剖析→分解
分家→分居
分散→分离
排列→分列
破裂→分裂
别离→分袂
排泄→分泌
临盆→分娩
争分夺秒→分秒必争
明白→分明
分配→分派
分派→分配
不同→分歧
两全→分身
分身乏术→分身不暇
分身不暇→分身乏术
分离→分手
辩白→分说
不相上下→分庭抗礼
特别→分外
一钱不受→分文不取
阐发→分析
人缘→分缘
付托→吩咐
派遣→吩咐消磨
纷纭→纷繁
庞杂→纷乱
不一→纷歧
骚动→纷扰
络绎不绝→纷至沓来
墓地→坟场
宅兆→坟墓
通宵达旦→焚膏继晷
焚掠→焚劫
焚劫→焚掠
大煞风景→焚琴煮鹤
屠烧→焚杀
点火→焚烧
袍笏登场→粉墨登场
赴汤蹈火→粉身碎骨
赴汤蹈火→粉身碎骨奋不顾身
遮盖→粉饰
破坏→粉碎
不屈不挠→奋不顾身
搏斗→奋斗
高昂→奋发
奋发图强→奋发蹈厉
奋发蹈厉→奋发图强
奋发图强→奋发向上
奋发蹈厉→奋发自强
抖擞→奋起
急起直追→奋起直追
奋勇争先→奋勇当先
奋勇当先→奋勇争先
恼恨→愤恨
气愤→愤恚
愤懑→愤激
愤怒→愤慨
怨愤→愤懑
丰产→丰登
品貌→丰度
富厚→丰富
劳苦功高→丰功伟绩
丰盛→丰厚
有年→丰年
人给家足→丰衣足食
充裕→丰裕
风浪→风波
风范→风采
跋山涉水→风餐露宿
栉风沐雨→风尘仆仆
追风逐电→风驰电掣
风姿潇洒→风度翩翩
帆船→风帆
风采→风范
气势派头→风格
风景→风光
风物→风景
风止→风静
狼吞虎咽→风卷残云
风波→风浪
凉爽→风凉
风骚→风流
烟消火灭→风流云散
风马牛不相及→风马不接
风马牛不相及→风马牛不相干
风采→风貌
风靡云蒸→风靡云涌
风靡云涌→风靡云蒸
海不扬波→风平浪静
汹涌澎拜→风起云涌
民风→风气
滑稽→风趣
电扇→风扇
风俗→风尚
土崩瓦解→风声鹤唳
民俗→风俗
风韵→风味
风景→风物
危害→风险
不胫而走→风行一时
大方→风雅
飞短流长→风言风语
风范→风仪
岌岌可危→风雨飘摇
休戚相关→风雨同舟
风姿→风韵
鹞子→风筝
风静→风止
品格→风致
行将就木→风烛残年
风度翩翩→风姿潇洒
册封→封爵
封闭→封锁
猖獗→疯狂
狼烟→烽火
尖锐→锋利
游戏人间→逢场作戏
化险为夷→逢凶化吉
钉扣子→缝扣子
漏洞→缝隙
讥笑→讽刺
比翼双飞→凤凰于飞
百里挑一→凤毛麟角
璧还→奉璧
逢迎→奉承
告知→奉告
璧还→奉还
衔命→奉命
作陪→奉陪
拜托→奉求
送上→奉上
服侍→奉侍
馈赠→奉送
推行→奉行
遵守习惯→奉行故事
服侍→奉养
讨好→奉迎
璧还→奉赵
释教→佛教
刀头之蜜→佛口蛇心
空门→佛门
梵宇→佛寺
梵学→佛学
剥极必复→否极必泰
时来运转→否极泰来
反对→否决
不然→否则
匹俦→夫妇
良人→夫君
伉俪→夫妻
挑夫→夫役
役夫→夫子
穴见→肤见
菲薄→肤浅
报告→敷陈
马马虎虎→敷衍了事
苟且偷生→敷衍塞责
富裕→敷裕
不可→弗成
伏诛→伏法
归隐志士→伏枥老骥
乐道安贫→伏枥守株
盗匪→伏莽
伏乞→伏祈
伏祈→伏乞
停当→伏贴
宓羲→伏羲
伏法→伏诛
服罪→伏罪
抱病→扶病
提携→扶携提拔
抚养→扶养
百尺竿头→扶摇直上
导引→扶引
扶助→扶直
建设→扶植
帮助→扶助
掠面→拂面
扫除→拂拭
破晓→拂晓
拂衣→拂袖
拂袖→拂衣
屈从→服从
仰药→服毒
吃法→服法
佩服→服气
奉养→服侍
衣饰→服饰
帖服→服帖
办事→服务
牢记→服膺
打扮→服装
伏罪→服罪
挑→浮薄
空洞→浮泛
走马看花→浮光掠影
佻薄→浮滑
水上人家→浮家泛宅
夸诞→浮夸
谰言→浮名
浮皮潦草→浮皮蹭痒
浮皮蹭痒→浮皮潦草
菲薄→浮浅
救生衣→浮水衣
宝塔→浮图
宝塔→浮屠
表现→浮现
蜚言→浮言
暴躁→浮躁
标记→符号
切合→符合
福气→福分
休咎→福祸
福分→福气
阿芙蓉→福寿膏
福寿绵绵→福寿绵长
福寿绵长→福寿绵绵
福寿绵绵→福寿无疆
福气→福泽
扪心自问→抚躬自问
弹琴→抚琴
观赏→抚玩
扪心→抚心
扶养→抚养
贵寓→府上
指正→斧正
如拾草芥→俯拾地芥
俯拾地芥→俯拾即是
唯命是听→俯首帖耳
寄人篱下→俯仰由人
釜中之鱼→釜中游鱼
俎上肉→釜中鱼
釜中游鱼→釜中之鱼
首相→辅弼
领导→辅导
子音→辅音
帮手→辅佐
糜烂→腐败
腐烂→腐臭
腐败→腐化
冬烘→腐儒
丁忧→父（母）丧
尊长→父老
怙恃→父母
地方官→父母官
世伯→父执
支付→付出
吩咐→付托
赋予→付与
一笑置之→付之一笑
排印→付梓
包袱→负担
担当→负担负责
抱屈→负屈
亏心→负心
扬汤止沸→负薪救火
失期→负约
卖力→负责
欠债→负债
赞同→附和
相近→附近
复生→复活
覆信→复书
苏醒→复苏
再起→复兴
回复复兴→复原
庞大→复杂
到差→赴任
出生入死→赴汤蹈火
配角→副角
帮手→副手
繁华→富贵
功名利禄→富贵荣华
丰富→富厚
大族→富家
金玉满堂→富可敌国
茂盛→富强
巨贾→富商
大亨→富翁
富裕→富足
钱粮→赋税
失业→赋闲
本性→赋性
付与→赋予
要地本地→腹地
查考→覆按
淹没→覆没
消灭→覆灭
反水不收→覆水难收
复书→覆信
应当→该当
活该→该死
乔妆→改扮
改弦易辙→改变方式
回心转意→改变主张
刊定→改定
窜改→改动
变动→改观
自新→改过
洗心革面→改过自新
再醮→改嫁
革新→改进
更名→改名
脱期→改期
他日→改日
改进→改善
洗面革心→改头换面
革故鼎新→改弦更张
除旧更新→改弦易辙
点窜→改削
放下屠刀→改邪归正
转业→改行
秘密警察→盖世太保
盖章→盖印
盖印→盖章
挡住→盖住
表面→概况
归纳综合→概括
大要→概略
观点→概念
提要→概要
干瘦→干瘪
爽性→干脆
快人快事→干脆爽快
寄父→干爹
冒犯→干犯
兵戈→干戈
劲头→干劲
凋谢→干枯
扳连→干连
谊母→干娘
与你何关→干卿底事
滋扰→干扰
干预干与→干涉
干预→干涉干与
做事→干事
干瘪→干瘦
关连→干系
罢手→干休
干涉→干与
过问→干预干与
旁证→干证
心悦诚服→甘拜下风
甘雨→甘霖
番薯→甘薯
甘愿宁可→甘心
蜜语→甘言
甘霖→甘雨
宁愿→甘愿
乐意→甘愿答应
甘心→甘愿宁可
美味→甘旨
坦怀相待→肝胆相照
肝胆相照→肝胆照人
怒气→肝火
粉身碎骨奋不顾身→肝脑涂地
凌驾→赶过
连忙→赶紧
从速→赶快
赶快→赶忙
遇上→赶上
趁早→赶早
感受→感触感染
感化→感导
感触→感到
戴德→感德
冲动→感动
戴德→感恩
结草衔环→感恩图报
抖擞→感奋
作用→感化
感激涕零→感激不尽
感激不尽→感激涕零
觉得→感觉
叹息→感喟
感愧交集→感愧并交
感愧并交→感愧交集
伤风→感冒
熏染→感染
动人→感人
动人肺腑→感人心曲
感慨→感伤
感觉→感受
叹息→感叹
谢谢→感谢
感激→感谢感动
感到→感应
独断专行→刚愎自用
适才→刚才
方才→刚刚
恰好→刚好
刚强→刚烈
固执→刚强
恰巧→刚巧
朴直→刚正
朴直→刚直
岗位→岗亭
岗亭→岗位
法纪→纲纪
大纲→纲领
大纲→纲目
口岸→港口
虎皮→皋比
笼络→皋牢
奋发→高昂
自豪→高傲
崎岖→高卑
超过跨过→高出
高峻→高大
高等→高档
崎岖→高低
岑岭→高峰
高屋建瓴→高高在上
古雅→高古
卓识→高见
朴直→高洁
高大→高峻
峻峭→高峻陡峭
印子钱→高利贷
高傲→高慢
高明→高妙
攀附→高攀
贵宾→高朋
宾朋盈门→高朋满座
头角峥嵘→高人一等
高妙→高深
大声→高声
不可一世→高视阔步
大模大样→高视阔步气宇轩昂
高视阔步→高视睨步
妙手→高手
遐龄→高寿
放言高论→高谈阔论
大作→高文
高高在上→高屋建瓴
开心→高兴
乐意→高兴愿意
雅致→高雅
法眼→高眼
飞腾→高涨
高着→高招
高枕无忧→高枕而卧
高作→高着
高招→高着儿
门生→高足
高着→高作
学费→膏火
公子哥儿→膏粱子弟
沃土→膏壤
腴膏→膏腴
恩典→膏泽
搅散→搞乱
办妥→搞妥
底稿→稿本
广告→告白
握别→告别
乐成→告成
告别→告辞
借款→告贷
告密→告发
紧急→告急
请假→告假
得胜→告捷
申饬→告诫
达成→告竣
辞职归里→告老还乡
密告→告密
讨饶→告饶
通告→告示
报告→告诉
辞职→告退
见告→告知
了结→告终
起诉→告状
陪罪→告罪
沙漠→戈壁
切断→割断
盘据→割据
分裂→割裂
画饼充饥→割肉医疮
停笔→搁笔
停顿→搁浅
弃捐→搁置
率土同庆→歌功颂德
笙歌→歌乐
女乐→歌女
赞美→歌颂
歌颂→歌咏
内室→阁房
左右→阁下
除旧更新→革故鼎新
斥革→革退
改造→革新
免职→革职
扞格难入→格格不入
形态体式→格式方式
分外→格外
形格势禁→格于环境
冷眼旁观→隔岸观火
隔邻→隔壁
隔膜→隔阂
阻遏→隔绝
隔断→隔绝距离
离隔→隔开
断绝→隔离
隔壁→隔邻
隔阂→隔膜
漠不关心→隔山观虎斗
个体→个别
小我私家→个人
本位主义→个人主义
个别→个体
本性→个性
本性难移→个性难改
其中→个中
局内人→个中人
参半→各半
各异→各别
互不侵犯→各不相犯
各执一词→各不相谋
到处→各处
列国→各国
各展其长→各尽所能
各种→各类
大家→各人
林林总总→各色各样
百般→各式
林林总总→各式各样
知无不言→各抒己见
列位→各位
各自进行→各行其是
百般→各样
各别→各异
半斤八两→各有千秋
各有千秋→各有所长
各尽所能→各展其长
互不相让→各执己见
各不相谋→各执一词
种种→各种
林林总总→各种各样
各不相谋→各自进行
各不相谋→各自为政
背道而驰→各走各路
准假→给假
赐与→给以
赐与→给予
接纳→给与
基础→根本
正本清源→根本治理
革除→根除
根基→根底
底子→根柢
底子→根蒂
基础→根蒂根基
基本→根基
探求→根究
凭据→根据
泉源→根源
跟从→跟班
跟随→跟从
衔接→跟尾
随着→跟着
更头→更次
调换→更调
变动→更动
变动→更改
铜漏滴尽→更鼓敲尽
越发→更加
深宵→更阑
改名→更名
不可偻指算→更仆难数
夜阑人静→更深人静
愈甚→更甚
重生→更生
鼎新→更始
更次→更头
换衣→更衣
改正→更正
佃户→耕户
农具→耕具
为人作嫁→耕人之田
秋毫无犯→耕市不惊
种田→耕田
耕作→耕耘
耕作→耕种
耕耘→耕作
铭心镂骨→耿耿于怀
朴直→耿介
大概→梗概
窒息→梗塞
朴直→梗直
阻塞→梗阻
工场→工厂
工厂→工场
光阴→工夫
东西→工具
半斤八两→工力悉敌
人为→工钱
领班→工头
产业→工业
工致→工整
灵巧→工致
人为→工资
事情→工作
弓套→弓鞬
射手→弓手
弓鞬→弓套
金莲→弓足
公役→公差
公正→公道
文移→公牍
公评→公断
大公无私→公而忘私
大公无私→公而无私
大公无私→公耳忘私
国法→公法
众怒→公愤
通告→公告
大众→公共
公开场合→公共场所
第宅→公馆
公文→公函
公众→公家
官价→公价
公然→公开
大庭广众→公开场合
正义→公理
通则→公例
百姓→公民
义冢→公墓
公审→公判
公断→公评
果然→公然
公判→公审
公务→公事
公牍→公文
公事→公务
公差→公役
条约→公约
公平→公允
通则→公则
评判人→公证人
民众→公众
令郎→公子
膏粱子弟→公子哥儿
纨子弟→公子王孙
半途而废→功败垂成
元勋→功臣
知难而退→功成身退
好事→功德
作业→功课
半途而废→功亏一篑
劳绩→功劳
功劳→功烈
法律→功令
富贵荣华→功名利禄
成果→功效
万试万灵→功效如神
功绩→功勋
服从→功用
打击→攻击
批评→攻讦
霸占→攻克
趁火打劫→攻其不备
百战百胜→攻无不克
攻陷→攻下
霸占→攻陷
求过于供→供不应求
口供→供词
招供→供认
进献→供献
扶养→供养
提供→供应
办事→供职
必恭必敬→恭恭敬敬
敬重→恭敬
阿谀→恭维
牢固→巩固
同谋→共谋
配合→共同
通力合作→共同努力
孝敬→贡献
勾通→勾串
活动→勾当
荡气回肠→勾魂摄魄
勾通→勾结
北里→勾栏
逗留→勾留
勾结→勾通
抹煞→勾消
取消→勾销
蛊惑→勾引
水渠→沟渠
相同→沟通
尔虞我诈→钩心斗角
狗窦→狗洞
狗洞→狗窦
垂死挣扎→狗急跳墙
驴蒙虎皮→狗仗人势
猪狗不如→狗彘不若
偷安→苟安
轻易→苟且
自甘堕落→苟且偷安
得过且过→苟且偷生
诛求无厌→苟求不已
打仗→构兵
组成→构成
造谣生事→构词惑众
谈判→构和
构想→构思
谋害→构陷
构思→构想
成仇→构怨
修筑→构筑
足数→够数
预计→估计
盘算推算→估计打算
贩子→估客
料中→估中
喁喁细语→咕咕唧唧
喋不休→咕哝不已
密斯→姑娘
临时→姑且
苏州→姑苏
养虎遗患→姑息养奸
孤独→孤傲
秘本→孤本
孑立→孤单
自命不凡→孤芳自赏
高慢→孤高
孤拐面→孤拐脸
孤拐脸→孤拐面
孤苦伶仃→孤家寡人
孤僻→孤介
单刀赴会→孤军作战
孤独→孤苦
孤家寡人→孤苦伶仃
伶仃→孤立
目光如豆→孤陋寡闻
孤介→孤僻
独木难支→孤掌难鸣
背注一掷→孤注一掷
死板→古板
古貌古心→古道热肠
骨董→古董
离奇→古怪
奇迹→古迹
老僧入定→古井不波
陈腐→古老
阴阳怪气→古里古怪
古道热肠→古貌古心
昔人→古人
庙宇→古刹
古董→古玩
从古到今→古往今来
高古→古雅
吉日→谷旦
株式会社→股份有限公司
发抖→股栗
古董→骨董
主干→骨干
节气→骨气
骨血→骨肉
兄弟阋墙→骨肉相残
骨肉→骨血
勾引→蛊惑
宣扬→鼓吹
鞭策→鼓动
激昂→鼓动感动
鼓励→鼓动勉励
宣扬→鼓动宣传
兴起→鼓起
鼓动→鼓舞
喧哗→鼓噪
拍手→鼓掌
抱残守缺→固步自封
牢固→固定
凝结→固结
坚如盘石→固若金汤
恪守→固守
顽强→固执
独断专行→固执己见
抱残守缺→故步自封
祖国→故国
故友→故交
素交→故旧
故宅→故居
故乡→故里
故交→故人
旧友→故人故交
故宅→故舍
故里→故乡
存心→故意
故交→故友
故宅→故园
故居→故宅
妨碍→故障
左支右绌→顾此失彼
忌惮→顾忌
主顾→顾客
挂念→顾虑
睥睨→顾盼
照料→顾问
珍惜→顾惜
怜惜→顾恤
孤苦伶仃→顾影自怜
主顾→顾主
招聘→雇用
店主→雇主
交替→瓜代
朋分→瓜分
扳连→瓜葛
顺理成章→瓜熟蒂落
起风→刮风
另眼相看→刮目相看
众寡不敌→寡不敌众
未亡人→寡妇
孀居→寡居
恬不知耻→寡廉鲜耻
挂花→挂彩
登记→挂号
挂心→挂记
顾虑→挂念
挂记→挂心
狠恶→乖戾
谬妄→乖谬
灵巧→乖巧
谬妄→乖张
诱骗→拐骗
含沙射影→拐弯抹角
手杖→拐杖
荒诞→怪诞
奇人→怪杰
四不像→怪样子
独特→怪异
关口→关隘
封闭→关闭
眷注→关怀
枢纽关头→关节
关隘→关口
干系→关连
闭门塞窦→关门落锁
关怀→关切
关键→关头
干系→关系
体贴→关心
看护→关照
存眷→关注
观察→观测
旁观→观察迟疑
看法→观点
旅行→观光
寓目→观看
看法→观念
抚玩→观赏
铤而走险→官逼民反
政界→官场
公价→官价
仕宦→官吏
权要→官僚
官厅→官署
讼事→官司
官署→官厅
例行公事→官样文章
堂而皇之→冠冕堂皇
灵柩→棺木
陈雷之契→管鲍之交
跑堂→管房
督工→管工
鄙见→管见
司库→管库
了如指掌→管窥蠡测
办理→管理
办事→管事
管制→管束
统领→管辖
会计→管帐
管束→管制
坐井观天→管中窥豹
同心同德→贯彻始终
连结→贯穿连接
领悟→贯通
防备→贯注
老例→惯例
注意灌输→灌入
贯注→灌输
注水→灌水
录音→灌音
贯注→灌注
灌输→灌注贯注
冰壶秋月→光风霁月
规复→光复
惠顾→光顾
千奇百怪→光怪陆离
王老五骗子→光棍
光彩→光华
平滑→光滑
圆通→光滑油滑
灿烂→光辉
劳驾→光驾
来临→光降
赤脚→光脚
风景→光景
到临→光临
光秃秃→光溜溜
灼烁→光明
正大光明→光明磊落
大公至正→光明正大
庆幸→光荣
言而不行→光说不练
言而不行→光说不做
青天白日→光天化日
秃顶→光头
光溜溜→光秃秃
鲜明→光鲜
显着→光鲜明显
光芒→光线
灿烂→光耀
时光→光阴
白驹过隙→光阴似箭
光芒→光泽
博识→广博
遍及→广泛
告白→广告
辽阔→广宽
广阔→广漠
走走→逛逛
合并→归并
归途→归程
返国→归国
送还→归还
返来→归来
返来→归来回头
概括→归纳综合
回去→归去
去世→归天
归程→归途
伏枥老骥→归隐志士
璧还→归赵
反正→归正
圭臬标准→圭表
模范→圭表标准
圭表标准→圭臬
模范→圭臬标准
长命→龟龄
鹤寿→龟年
鸨母→龟婆
五十步笑百步→龟笑鳖无尾
躲避→规避
范例→规范
光复→规复
规行矩步→规规矩矩
筹划→规画
针砭→规戒
端正→规矩
纪律→规律
劝戒→规劝
安分守己→规行矩步
箴言→规语
阃范→闺范
内室→闺房
内室→闺阁
宝贝→瑰宝
美丽→瑰丽
离奇→瑰异
法式→轨范
法则→轨则
制度→轨制
妖言惑众→诡辞欺世
企图→诡计
秘密→诡秘
巧夺天工→鬼斧神工
鬼魅→鬼怪
偷偷摸摸→鬼鬼祟祟
大话→鬼话
幽灵→鬼魂
厮混→鬼混
磷火→鬼火
天愁地惨→鬼哭神号
鬼怪→鬼魅
地府→鬼门关
鬼摸脑壳→鬼迷心窍
鬼迷心窍→鬼摸脑壳
阴差阳错→鬼使神差
鬼鬼祟祟→鬼头鬼脑
黄泉→鬼域
阴谋诡计→鬼域伎俩
卑劣手段→鬼蜮伎俩
高朋→贵宾
王侯→贵爵
高朋→贵客
朱紫→贵人
玉体→贵体
闻达→贵显
尊姓→贵姓
令坦→贵婿
贵显→贵要
府上→贵寓
宝贵→贵重
王孙公子→贵族子弟
木樨→桂花
一枝独秀→桂林一枝
膜拜→跪拜
结存→滚存
滚开→滚蛋
转动→滚动
倒背如流→滚瓜烂熟
滔滔→滚滚
滚蛋→滚开
沸水→滚水
欺骗→棍骗
汽锅→锅炉
邦本→国本
国学→国粹
都城→国都
民贼→国蠹
王法→国法
中流砥柱→国家栋梁
邦家之光→国家荣誉
邦交→国交
版图→国界
民穷财尽→国困民艰
邦本→国脉
百姓→国民
天姿国色→国色天香
外洋→国外
国粹→国学
鼎祚→国运
民贼→国贼
鼎祚→国祚
坚定→果断
充饥→果腹
大胆→果敢
公然→果然
果然→果真
扎脚→裹足
停滞不前→裹足不前
不对→过错
过分→过度
太过→过分
不知恩义→过河拆桥
不知恩义→过河抽板
事后→过后
因循自误→过后行兵
度日→过活
偏激→过火
过目成诵→过目不忘
逾期→过期
已往→过去
盘盘大才→过人才略
过头→过甚
名过其实→过甚其词
夸大其词→过甚其辞
名过其实→过甚其实
不对→过失
过期→过时
鞫讯→过堂
干涉→过问
留宿→过夜
矫枉过正→过犹不及
弯腰→哈腰
尸骨→骸骨
海隅→海阪
风平浪静→海不扬波
浪潮→海潮
杳如黄鹤→海底捞针
包涵→海涵
天涯→海角
天涯海角→海角天涯
水师→海军
天长地久→海枯石烂
天南地北→海阔天空
波浪→海浪
梦幻泡影→海市蜃楼
天长地久→海誓山盟
天南地北→海说神聊
外洋→海外
海阪→海隅
水手→海员
海底捞针→海中捞月
惊诧→骇怪
耸人听闻→骇人听闻
抱病→害病
贻害不浅→害人不浅
怕羞→害臊
含羞→害羞
畅快→酣畅
甜睡→酣睡
痛饮→酣饮
鏖战→酣战
大醉→酣醉
敦朴→憨厚
委曲求全→含垢忍辱
抱恨→含恨
暗昧→含糊
模棱两可→含糊其词
迷糊→含混
吞吐其词→含混其词
浅笑→含笑
含笑入地→含笑九泉
含笑九泉→含笑入地
历尽艰辛→含辛茹苦
怕羞→含羞
蕴藉→含蓄
含沙射影→含血喷人
寄义→含义
抱屈→含冤
南柯一梦→邯郸一梦
黄粱一梦→邯郸之梦
尺牍→函牍
翰札→函件
修养→涵养
慌不择路→寒不择衣
隆冬→寒冬
北风→寒风
冷光→寒光
冷害→寒害
敝宅→寒家
寒战→寒噤
牛衣对泣→寒门饮恨
冷气→寒气
舍下→寒舍
冷天→寒天
微贱→寒微
交际→寒暄
冬衣→寒衣
哆嗦→寒战
稀有→罕见
少用→罕用
罕见→罕有
华文→汉文
男人→汉子
汗如雨下→汗出如浆
汗出如浆→汗流浃背
放荡→汗漫
历史→汗青
汗流浃背→汗如雨下
笠衫→汗衫
内疚→汗下
泼妇→悍妇
蛮横→悍戾
不顾一切→悍然不顾
大盗→悍贼
笔墨→翰墨
简牍→翰札
帆海→航海
航线→航路
航路→航线
飞行→航行
绝不→毫不
心甘情愿→毫不勉强
光芒→毫光
肆无忌惮→毫无所惧
奢侈→豪侈
豪放→豪宕
大富→豪富
好汉→豪杰
壮举→豪举
阔气→豪阔
权门→豪门
英气→豪气
感情→豪情
豪迈→豪爽
英雄仗义→豪侠好义
牛饮→豪饮
放肆→豪恣
好身手→好本领
比如→好比
十分困难→好不容易
佳肴→好菜
很多多少→好多
多事生非→好管闲事
豪杰→好汉
优劣→好坏
昙花一现→好景不常
很久→好久
压轴好戏→好酒沉瓮底
悦目→好看
美梦→好梦
善门难开→好人难做
好本领→好身手
慈悲心肠→好生之德
功德→好事
鲜花易谢→好事多磨
妙手→好手
恰似→好似
晴天→好天
有始有终→好头不如好尾
宛如→好像
可笑→好笑
美意→好心
勤学→好学
吊儿郎当→好逸恶劳
美意→好意
摰友→好友
幸亏→好在
军号→号角
悲啼→号哭
命令→号令
悲啼→号泣
礼服→号衣
招呼→号召
浩荡→浩大
浩大→浩荡
众多→浩繁
众多→浩瀚
声势赫赫→浩浩荡荡
大难→浩劫
长吁→浩叹
痛饮→浩饮
泯灭→耗费
消耗→耗损
呵斥→呵叱
呵叱→呵斥
庇护→呵护
欠伸→呵欠
呼→呵责
斥责→呵
喝彩→喝采
喝采→喝彩
品茗→喝茶
饮酒→喝酒
归并→合并
正当→合法
合伙→合股
合资→合伙
百口→合家
公道→合理
协力→合力
戮力同心→合力攻敌
同谋→合谋
失而复得→合浦还珠
失而复得→合浦珠还
通情达理→合情合理
称身→合身
适时→合时
符合→合适
条约→合同
满意→合意
配合→合营
适用→合用
合股→合资
互助→合作
紧密合作→合作无懈
满堂→合座
何须→何必
那边→何处
多么→何等
何关→何干
何以→何故
何干→何关
那堪→何堪
况且→何况
奈何→何如
作甚→何为
何必→何须
何故→何以
安在→何在
不值一提→何足道哉
平和→和蔼
平易近人→和蔼可掬
蔼然可亲→和蔼可亲
和洽→和好
暖和→和缓
息争→和解
友爱→和睦
暖和→和暖
尽情宣露→和盘托出
宁静→和平
和好→和洽
和蔼→和善
僧人→和尚
鲁仲连→和事老
温顺→和顺
协议→和谈
柔顺→和婉
调和→和谐
暖和→和煦
平易近人→和颜悦色
协议同意→和议
平和→和悦
风雨同舟→和衷共济
河滨→河边
河边→河滨
河神→河伯
河流→河道
畏妻如虎→河东狮吼
河滨→河干
天河→河汉
河道→河流
河边→河畔
风平浪静→河清海晏
国土→河山
河伯→河神
查究→核办
审定→核定
查对→核对
焦点→核心
中心人物→核心分子
审阅→核阅
批准→核准
钱袋→荷包
当兵→荷戈
拜年→贺年
道喜→贺喜
大名鼎鼎→赫赫有名
白发→鹤发
佼佼不群→鹤立鸡群
龟年→鹤寿
暗中→黑暗
好坏→黑白
善恶不分→黑白不分
阴森森→黑沉沉
斑点→黑点
黑压压→黑糊糊
私货→黑货
内幕→黑幕
陋规→黑钱
玄色→黑色
暗盘→黑市
梦境→黑甜乡
黑糊糊→黑压压
黑糊糊→黑黝黝
陈迹→痕迹
好多→很多多少
好久→很久
非常→很是
猛烈→狠恶
恨之入骨→恨入骨髓
恨入骨髓→恨之入骨
大路→亨衢
利市→亨通
满坑满谷→恒河沙数
长期→恒久
蛮横→横暴
绵亘→横亘
高出→横跨
瞋目→横眉
怒目→横目
颠三倒四→横三竖四
反正→横竖
非命→横死
胡作非为→横行霸道
苛捐杂税→横征暴敛
房屋→衡宇
惊动→轰动
大张旗鼓→轰轰烈烈
霹雳→轰隆
砰然→轰然
盛传→哄传
一时哄动→哄传一时
引动→哄动
利用→哄骗
骗人→哄人
陪衬→烘托
宏大→弘大
远大→弘远
大志→弘愿
尘世→红尘
赤军→红军
盈余→红利
赤色→红色
彤霞→红霞
不安于室→红杏出墙
朱颜→红颜
美人命薄→红颜薄命
弘大→宏大
广博→宏大辽阔
豪迈→宏放
佳构→宏构
嘹亮→宏亮
博学多才→宏儒硕学
高大→宏伟
大志→宏愿
宏大→宏壮
嘹亮→洪亮
大水→洪流
大水→洪水
大志→洪志
杳杳无踪→鸿飞冥冥
边界→鸿沟
青云之志→鸿鹄之志
鸿猷→鸿图
大作→鸿文
鸿图→鸿猷
隆运→鸿运
山公→猴子
咆哮→吼怒
背面→后背
子弟→后辈
子女→后代
后援→后盾
后来居上→后发先至
结果→后果
悔恨→后悔
追悔不及→后悔无及
跋文→后记
落伍→后进
厥后→后来
青出于蓝→后来居上
背面→后面
继室→后妻
少年老成→后生可畏
后代→后世
子息→后世昆裔
背工→后手
背景→后台
背面→后头
退却→后退
后代→后裔
后盾→后援
反冲力→后坐力
重酬→厚酬
厚遇→厚待
老实→厚道
知交→厚交
重利→厚利
外温内厚→厚貌深情
丰富→厚实
美味→厚味
恬不知耻→厚颜无耻
厚待→厚遇
叱责→呼叱
呼唤→呼喊
呼唤→呼叫
呼喊→呼叫招呼
呼么喝六→呼卢喝雉
呼卢喝雉→呼么喝六
号令→呼吁
哗闹→呼噪
呵责→呼
蓦地→忽地
闷闷不乐→忽忽不乐
乍寒乍热→忽冷忽热
纰漏→忽略
轻忽→忽视
腋臭→狐臭
仗势欺人→狐假虎威
媚惑→狐媚
疑心→狐疑
马贼→胡匪
厮混→胡混
浑浑噩噩→胡里胡涂
厮闹→胡闹
乱说→胡说
颠三倒四→胡说八道
妙想天开→胡思乱想
放肆荒唐→胡天胡地
弄堂→胡衕
颟顸→胡涂
聪明一世→胡涂一时
梦想→胡想
髯毛→胡须
颠三倒四→胡言乱语
扯谈→胡诌
横行霸道→胡作非为
生活→糊口
生存→糊口生涯
乱来→糊弄
豺狼→虎豹
爪牙→虎伥
猛将→虎将
死里逃生→虎口余生
鹰视→虎睨
皋比→虎皮
有头无尾→虎头蛇尾
军营→虎帐
各不相犯→互不侵犯
各执己见→互不相让
交换→互换
通商→互市
相互→互相
息息相关→互相关注
切磋琢磨→互相研究
各别→互异
相助→互助
照顾护士→护理
保护→护卫
花卉→花草
旦角→花旦
耗费→花费
十丈软红→花花世界
花草→花卉
园丁→花匠
混名→花名
花园→花圃
月下花前→花前月下
费钱→花钱
花样→花腔
闭月羞花→花容月貌
格式→花式
灯红酒绿→花天酒地
五彩缤纷→花团锦簇
斑纹→花纹
耗费→花消
甜言蜜语→花言巧语
格式→花样
花圃→花园
浓妆艳抹→花枝招展
浪费→华侈
脆而不坚→华而不实
门庭若市→华盖云集
大札→华翰
西岳→华山
药到病除→华陀再世
汉文→华文
中原→华夏
鲜衣美食→华衣美食
叛变→哗变
嘈吵喧斗→哗闹
喧笑→哗笑
溜冰→滑冰
风趣→滑稽
诙谐百出→滑稽突梯
光滑→滑腻
平滑→滑润
平滑→滑润圆滑
狡徒→滑头
费尽心机→化尽心血
假名→化名
子虚乌有→化为乌有
转败为功→化险为夷
扮装→化装
荡舟→划船
规定→划定
规则→划定规矩
分别→划分
同等→划一
小船→划子
割肉医疮→画饼充饥
刻鹄类鹜→画虎成犬
一语道破→画龙点睛
多此一举→画蛇添足
绘图→画图
口实→话柄
交浅言深→话不投机
叙旧→话旧
发话器→话筒
度量→怀抱
象齿焚身→怀璧其罪
抱恨→怀愁
挟恨→怀恨
吊唁→怀念
妊娠→怀胎
缅怀→怀想
猜疑→怀疑
抱恨→怀怨
有身→怀孕
弊端→坏处
浮名→坏话
暴徒→坏人
欢快→欢畅
高兴→欢快
高兴→欢乐
陶然→欢然
高兴→欢腾
眉飞色舞→欢天喜地
忻忭→欢忻
欢乐→欢欣
兴高采烈→欢欣鼓舞
接待→欢迎
欢腾→欢娱
快乐→欢愉
欢腾→欢悦
反击→还击
照旧→还是
回籍→还乡
另有→还有
环绕→环抱
家贫壁立→环堵萧然
环视→环顾
关键→环节
情况→环境
举世→环球
缠绕→环绕纠缠
环顾→环视
漫步→缓步
安步当车→缓步徐行
和缓→缓和
徐徐→缓缓
迟钝→缓慢
脱期→缓期
变幻→幻化
幻境→幻景
幻梦→幻境
幻境→幻梦
梦幻泡影→幻梦成空
把戏→幻术
阉人→宦官
官场→宦海
仕途→宦途
叫醒→唤醒
调班→换班
调换→换取
拜把兄弟→换帖兄弟
易服→换衣
面目全非→涣然一新
分散→涣散
抱病→患病
磨难→患难
同命鸳鸯→患难夫妻
抖擞→焕发
面目一新→焕然一新
饲养→豢养
怪诞→荒诞
荒谬绝伦→荒诞不经
荒唐→荒诞乖张
疏弃→荒废
谬妄→荒谬
荒诞不经→荒谬绝伦
荒原→荒漠
歉岁→荒年
偏僻→荒僻
偏僻→荒僻罕见
僻静→荒僻冷僻
荒废→荒疏
荒诞→荒唐
荒废→荒芜
荒淫无度→荒淫无耻
荒淫无耻→荒淫无度
寒不择衣→慌不择路
丢魂失魄→慌慌张张
毛姜→慌脚鸡
匆忙→慌忙
天子→皇帝
人力车→黄包车
金灿灿→黄灿灿
薄暮→黄昏
乳臭未干→黄口孺子
通书→黄历
南柯一梦→黄粱一梦
鬼域→黄泉
惶遽→惶惶
胆战心惊→惶惶不安
惶惶→惶惑
惶惶→惶遽
惊骇→惶恐
模糊→恍惚
名顿开→恍然大悟
晃悠→晃荡
摆荡→晃动
晃动→晃悠
大话→谎话
谎话→谎言
昏暗→灰暗
尘土→灰尘
悲观→灰心
暮气沉沉→灰心丧气
规复→恢复
广大→恢弘
摆荡→挥动
招招手→挥挥手
挥金如土→挥霍无度
一掷千金→挥金如土
洒泪→挥泪
笔底生花→挥洒自如
鲜丽→辉煌光耀
照映→辉映
复兴→回复
复原→回复复兴
反老回童→回复青春
回答→回覆
回首→回顾
回首→回顾回头
返国→回国
保护→回护
回手→回击
回乡→回籍
谢绝→回绝
背工→回扣
返来→回来
返来→回来离去
祝融→回禄
归去→回去
转身→回身
应声→回声
接纳→回收
回击→回手
回顾→回首
回首→回首回头回忆
无法复生→回天乏术
转头→回头
悬崖勒马→回头是岸
旋里→回乡
反响→回响
反应→回响反映
追念→回想
返梢→回销
转意→回心
改变主张→回心转意
复书→回信
盘旋→回旋扭转
覆信→回音
佣钿→回佣
反转展转→回转
辩驳→回嘴
改过→悔改
痛恨→悔恨
后悔→悔怨
报告请示→汇报
搜集→汇集
聚餐→会餐
聚集→会萃
会集→会合
会合→会集
管帐→会计
访问→会见
碰面→会面
讨论→会商
礼堂→会堂
会面→会晤
集会→会议
闪烁其词→讳莫如深
遮掩→讳饰
栩栩如生→绘声绘色
历历如绘→绘声绘影
画图→绘图
历历如绘→绘影绘声
行贿→贿赂
昏暗→晦暗
不利→晦气
艰涩→晦涩
不伤脾胃→惠而不费
光顾→惠顾
光临→惠临
破坏→毁坏
扑灭→毁灭
损伤→毁伤
惨淡→昏暗
昏迷→昏倒
颟顸→昏瞶
朦胧→昏黄
昏迷→昏厥
昏倒→昏迷
不省人事→昏迷不醒
天昏地暗→昏天黑地
亲事→婚事
胡里胡涂→浑浑噩噩
内助→浑家
天真未凿→浑金璞玉
十全十美→浑然一体
满身→浑身
乘虚而入→浑水摸鱼
污浊→浑浊
丢魂失魄→魂不附体
漫不经心→魂不守舍
六神无主→魂飞魄散
六神无主→魂飞天外
灵魂→魂灵
灵魂→魂魄
忘八→混蛋
混淆→混合
地痞→混混
杂居→混居
花名→混名
胡闹→混闹
满身→混身
浑水摸鱼→混水摸鱼
浴池→混堂
混杂→混同
等量齐观→混为一谈
殽杂→混淆
颠倒黑白→混淆黑白
混淆黑白→混淆视听
稠浊→混杂
浑浊→混浊
豪迈→豁达
明亮→豁亮
宽宏大量→豁略大度
宽免→豁免
猜拳→豁拳
名顿开→豁然开朗
该死→活该
活扣→活结
活结→活扣
活龙活现→活灵活现
龙马精神→活龙活现
生路→活路
灵敏→活络
生坑→活埋
生路→活门
生擒→活捉
在世→活着
同伴→火伴
洋火→火柴
暖锅→火锅
火葬→火化
迫切→火急
火灾→火警
兵器→火器
烈日当空→火伞高张
推波助澜→火上加油
推波助澜→火上浇油
迫不及待→火烧眉毛
人烟→火食
灯火辉煌→火树银花
敏捷→火速
庖丁→火头
前线→火线
炸药→火药
煤油→火油
火警→火灾
火化→火葬
为人作嫁→火中取栗
同伴→伙伴
店员→伙计
炊事→伙食
庖丁→伙头
某人→或人
大概→或许
或谓→或曰
大概→或者
钱币→货币
堆栈→货仓
堆栈→货仓旅馆
拨浪鼓→货郎鼓
货色→货品
货币→货泉
货物→货色
货品→货物
得到→获得
得罪→获咎
得救→获救
赢利→获利
利市三倍→获利优厚
得胜→获胜
开罪→获罪
灾患丛生→祸不单行
祸发齿牙→祸从口出
祸根→祸端
祸从口出→祸发齿牙
祸端→祸根
病国殃民→祸国殃民
祸患→祸害
祸殃→祸患
沧海横流→祸乱滔天
罪魁→祸首
祸根→祸胎
祸患→祸殃
讽刺→讥嘲
讽刺→讥刺
调侃→讥讽
讥嘲→讥诮
讽刺→讥笑
伐鼓→击鼓
拍案叫绝→击节称赏
打更→击柝
寒不择衣→饥不择食
大肠告小肠→饥肠辘辘
啼饥号寒→饥寒交迫
构造→机关
机敏→机灵
机灵→机敏
权谋→机谋
性能→机能
呆板→机器
机器→机械
秘密→机要
机遇→机缘
刁狡→机诈
机警→机智
心裁→机杼
珠圆玉润→肌理丰盈
鸡飞狗走→鸡飞狗跳
鸡飞狗跳→鸡飞狗走
琐屑零星→鸡零狗碎
消灭净尽→鸡犬不留
鸡飞狗跳→鸡犬不宁
一人得道→鸡犬升天
势如水火→积不相容
积蓄→积储
积蓄→积存
行善→积德
源远流长→积厚流光
浸渐→积渐
历年→积年
年深月久→积年累月
积德→积善
集腋成裘→积少成多
水滴石穿→积习沉舟
积重难返→积习难改
积贮→积蓄
聚蚊成雷→积羽沉舟
积习难改→积重难返
积蓄→积贮
下层→基层
底子→基础
底子→基础底细
捉拿→缉捕
盘蹲→箕踞
稽察→稽查
稽察→稽查查察
稽查→稽察
稽查→稽察查察
拖延→稽迟
考核→稽核
顿首→稽首
拖延→稽延
鼓动感动→激昂
慷慨→激昂大方
舌战→激辩
荡漾→激荡
激昂→激动慷慨
引发→激发
激怒→激愤
急流→激流
激愤→激怒
亲热→激情亲切
鼓励→激劝
登科→及第
捷足先登→及锋而试
豆蔻年华→及笄年华
实时→及时
赶早→及早
防患未然→及早防备
吉祥→吉利
吉士→吉人
善者神佑→吉人天相
谷旦→吉日
吉人→吉士
祥瑞→吉祥
休咎→吉凶
佳兆→吉兆
罗致→汲取
心余力绌→汲深绠短
打水→汲水
提拔→汲引
马上→即刻
克日→即日
纵然→即使
便是→即是
马上→即速
登基→即位
顶点→极点
非常→极度
极度→极端
颠峰→极峰
淋漓尽致→极尽描摹
神仙世界→极乐世界
冰冷→极冷
尽力→极力
马首是瞻→极力模仿
纵目→极目
少少→极少
崭新→极新
死罪→极刑
綦重→极重
深重→极重繁重
急忙忙→急巴巴
遽变→急变
岌岌可危→急不可待
仓促→急促
慷慨仗义→急公好义
急忙忙→急乎乎
仓促→急急
快快当当→急急巴巴
快快当当→急急忙忙
抢救→急救
急忙→急遽
激流→急流
功成身退→急流勇退
急遽→急忙
急乎乎→急忙忙
迫切→急迫
奋起直追→急起直追
火急→急切
迫不及待→急如星火
临渴掘井→急时抱佛脚
连忙→急速
敏捷→急迅
情急智生→急中生智
痛苦→疾苦
声色俱厉→疾言厉色
狂奔→疾走
捷足先登→疾足先得
调集→集结
群策群力→集思广益
团体→集体
聚沙成塔→集腋成裘
会合→集中
妒忌→嫉妒
编录→辑录
和睦→辑睦
和睦→辑穆
没没无闻→籍籍无名
频频→几次
多少→几多
多少→几何
险些→几乎
几次→几回
一再→几回再三
多少→几许
爱人如己→己饥己溺
计谋→计策
算无遗策→计划精巧
计算→计较
战略→计谋
小手小脚→计无所出
讨论→计议
算帐→计帐
挂念→记挂
暗号→记号
记着→记取
记录→记实
影象→记忆
念念不忘→记忆犹新
纪录→记载
记着→记住
记取→记着
本领→伎俩
跃跃欲试→伎痒
记录→纪录
规律→纪律
编年→纪年
怀念→纪念
游记→纪行
忌日→忌辰
顾忌→忌惮
隐讳→忌讳
忌辰→忌日
武术→技击
款式→技俩
本领→技能花样
本领→技巧
技能→技术
妙技→技术手段
摩拳擦掌→技痒
武艺→技艺
境遇→际遇
仲父→季父
季节→季候
季候→季节
末世→季世
幼子→季子
囊空如洗→季子囊空
救急→济急
雪中送炭→济困扶危
雪中送炭→济困解危
承继→继承
后妻→继配
后妻→继室
绍述→继述
承前启后→继往开来
连续→继续
络绎不绝→继续不停
克绍箕裘→继志述事
沉寂→寂静
寥寂→寂静落寞
枯寂→寂聊
寥寂→寂寥
寥寂→寂寞
肃然→寂然
寄存→寄放
义父→寄父
托足→寄迹
俯仰由人→寄人篱下
托身→寄身
投止→寄宿
拜托→寄托
留意→寄望
含义→寄义
寓意→寄意
敬拜→祭奠
祭奠→祭祀
更加→加倍
侵犯→加害
加速→加快
加快→加速
添补→加添
私人亲信→夹袋中人物
混合→夹杂
背工→夹帐
兵凶战危→佳兵不祥
杰作→佳构
韵事→佳话
美人→佳丽
匹俦→佳偶
嘉偶天成→佳偶天成
夫妇→佳耦
美人→佳人
好菜→佳肴
美誉→佳誉
吉兆→佳兆
镣铐→枷锁
桎梏→枷锁束缚
产业→家产
屡见不鲜→家常便饭
祖传→家传
产业→家当
家境→家道
仆人→家丁
家道→家境
环堵萧然→家贫壁立
门风→家声
门第→家世
乡信→家书
派别→家数
萧墙之祸→家庭祸变
室如悬磬→家徒壁立
贫无立锥→家徒四壁
家书→家信
六畜→家畜
故里→家园
眷属→家属
家属→家族
高朋→嘉宾
美谈→嘉话
盛会→嘉会
夸奖→嘉奖
夸奖→嘉勉
佳偶天成→嘉偶天成
赞美→嘉赞
船面→甲板
头等→甲等
头等→甲第
军人→甲士
蟑螂→甲由
团鱼→甲鱼
代价→价格
代价→价值
价值千金→价值连城
无价之宝→价值千金
跨鹤西归→驾返瑶池
劳驾→驾临
得心应手→驾轻就熟
驾御→驾驭
驾驭→驾御
含沙射影→架词诬控
排挤→架空
托辞→假称
冒充→假充
借贷→假贷
营私舞弊→假公济私
赝品→假货
冒充→假冒
化名→假名
伪钞→假票
假装好人→假仁假义
沐日→假日
倘使→假如
倘使→假若
倘使→假使
冒充→假意
虚与委蛇→假意周旋
定居→假寓
冒充→假装
假仁假义→假装好人
移祸→嫁祸
以邻为壑→嫁祸他人
以邻为壑→嫁祸于人
嫁妆→嫁奁
妆奁→嫁妆
农事→稼穑
狡猾→奸刁
奸徒→奸棍
奸诈→奸滑
奸狡→奸猾
奸刁→奸狡
奸淫→奸骗
奸诈→奸巧
暴徒→奸人
市侩→奸商
奸淫→奸通奸骗
奸棍→奸徒
特工→奸细
刁滑→奸险
狞笑→奸笑
刁滑→奸诈
哨兵→尖兵
刻薄→尖刻
锋利→尖锐
刻薄→尖酸
繁言吝啬→尖酸刻薄
焦土政策→坚壁清野
坚如盘石→坚不可摧
对峙→坚持
坚韧不拔→坚持不懈
贯彻始终→坚持到底
峻拒→坚辞
刚强→坚定
百折不挠→坚定不移
刚强→坚决
困难→坚苦
历尽艰辛→坚苦卓绝
坚固→坚忍
坚固→坚韧
坚持不懈→坚韧不拔
固若金汤→坚如盘石
坚固→坚实
服从→坚守
坚贞→坚毅
威武不屈→坚毅不拔
刚正→坚毅刚烈
坚固→坚硬
坚忍→坚贞
扑灭→歼灭
岌岌可危→间不容发
特工→间谍
中断→间断
断绝→间断中止
隔断→间隔
肩摩踵接→肩背相望
负担→肩负
亚肩迭背→肩摩毂击
前后相接→肩摩踵接
困难→艰巨
费力→艰苦
勤勤俭俭→艰苦朴素
晦涩→艰涩
深邃→艰深
多事之秋→艰屯之际
艰苦→艰辛
吞并→兼并
分身→兼顾
缧绁→监仓
犯人→监犯
督工→监工
羁系→监管
羁系→监禁
缧绁→监牢
牢狱→监狱
闭口→缄口
默不作声→缄口不言
闭口无言→缄口藏舌
闭口无言→缄口结舌
闭口无言→缄口无言
沉默→缄默沉静
守口如瓶→缄舌闭口
挑撰→拣选
节俭→俭仆
朴实→俭朴
朴实→俭省
节俭→俭约
跌价→减价
逊色→减色
淘汰→减少
节减→减省
节减→减削
弛刑→减刑
铰剪→剪刀
剃头→剪发
同窗夜语→剪烛西窗
查抄→检查
查察→检察
检点→检核
检点→检核检束
检点→检束
检验→检讨
检验→检修
查验→检验
校阅阅兵→检阅
演武厅→检阅场
校阅→检阅校对
轻便→简便
翰札→简牍
简便→简洁
简便→简捷
大略→简陋
大略→简略
简易→简略单纯
节减→简略节略
浅易→简易
的确→简直
博古通今→见多识广
见机行事→见风使舵
看风使舵→见风转舵
告知→见告
见责→见怪
识趣→见机
量体裁衣→见机而作
见风使舵→见机行事
见示→见教
施礼→见礼
不知恩义→见利忘义
包涵→见谅
跃跃欲动→见猎心喜
晤面→见面
重色轻友→见色忘友
见地→见识
少见多怪→见识浅短
漠不关心→见死不救
尝鼎一脔→见微知着
博古通今→见闻广博
目染耳濡→见闻习染
收效→见效
贻笑大方→见笑于人
当仁不让→见义勇为
喜新厌旧→见异思迁
包涵→见原
见怪→见责
示知→见知
定都→建都
立功→建功
开国→建国
创建→建立
设置装备摆设→建设
建立→建树
发起→建议
制作→建造
修建→建筑
一触即发→剑拔弩张
平沽→贱卖
粗躯→贱躯
卑视→贱视
顽躯→贱体
康健→健康
忘记→健忘
强健→健旺
结实→健壮
推行→践诺
残害→践踏糟踏
履言→践言
如约→践约
莅祚→践祚
判定→鉴定
警戒→鉴戒
察言观色→鉴貌辨色
观赏→鉴赏
辨别→鉴识
江畔→江干
一落千丈→江河日下
江干→江畔
山河→江山
临渴掘井→江心补漏
海底捞针→江中钓月
快要→将近
未来→将来
半信半疑→将信将疑
棋逢敌手→将遇良才
对峙→僵持
战场→疆场
版图→疆土
领土→疆域
失言→讲错
媾和→讲和
发言→讲话
论价→讲价
授课→讲课
表明→讲明
考究→讲求
教学→讲授
报告→讲述
课堂→讲堂
报告→讲演
课本→讲义
赏罚→奖惩
夸奖→奖赏
称赞→奖饰
别开生面→匠心独运
胸中有数→匠意于心
低落→降低
克服→降服
投降→降服佩服
贬价→降价
到临→降临
诞生→降生
接班→交班
打仗→交兵
交织→交叉
交接→交代
反目→交恶
比武→交锋
互换→交换
外交→交际
交迫→交煎
交代→交接
交煎→交迫
话不投机→交浅言深
友爱→交情
交界→交壤
融会→交融
谈判→交涉
比武→交手
攀谈→交谈
瓜代→交替
窃窃私议→交头接耳
吩咐→交托
交代→交卸
谈心→交心
生意业务→交易
情谊→交谊
来往→交游
结交→交友
行运→交运
征战→交战
吵骂→交谪
郊野→郊外
田野→郊野
远足→郊游
妩媚→娇媚
羞人答答→娇羞答答
骄纵→娇纵
浇漓→浇薄
解愁→浇愁
浇薄→浇漓
傲卒多败→骄兵必败
骄矜→骄贵
高慢→骄横
骄贵→骄矜
高慢→骄气
心高气傲→骄气十足
烈日→骄阳
轻慢→骄易
傲卒多败→骄者必败
宠儿→骄子
骄纵→骄恣
纠纷→胶葛
菲林→胶卷
如胶似漆→胶漆相投
刻舟求剑→胶柱鼓瑟
核心→焦点
发急→焦虑
坚壁清野→焦土政策
焦急→焦心
焦虑→焦炙
焦急→焦炙焦虑
发急→焦灼
比力→角力计较
谯楼→角楼
脚色→角色
比赛→角逐
荣幸→侥幸
调皮→狡猾
诡计→狡计
抵赖→狡赖
滑头→狡徒
强健→矫健
灵活→矫捷
装腔作势→矫揉造作
卖弄→矫饰
过犹不及→矫枉过正
剧本→脚本
夫役→脚夫
脚印行踪→脚迹
力钱→脚钱
角色→脚色
投机取巧→脚踏两船
实事求是→脚踏实地
脚迹→脚印
脚迹→脚印行踪
剪刀→铰剪
搭钮→铰链
混淆→搅浑
剿灭→剿除
德威并用→剿抚兼施
剿除→剿灭
袭取→剿袭
叫唤→叫喊
喝采→叫好
托钵人→叫花子
求乞→叫化
啼声→叫声
哗闹→叫嚣
唤醒→叫醒
哨子→叫子
肩舆→轿子
较量→较劲
比力→较量
计算→较量争论
明显→较着
课本→教材
辅导→教导
教养→教化
锻练→教练
西席→教师
课堂→教室
传授→教授
教学→教授教养
挑拨→教唆
讲授→教学
教导→教训
修养→教养
教诲→教育
老师→教员
阶级→阶层
阶层→阶级
门路→阶梯
囚徒→阶下囚
咸宜→皆宜
交班→接班
接棒人→接班人
接手→接办
接班人→接棒人
打仗→接触
欢迎→接待
连续不断→接二连三
拂尘→接风
接受→接管
攀龙附凤→接贵攀高
帮助→接济
访问→接见
会晤→接见会面
靠近→接近
连续→接连
纷至沓来→接连不断
采取→接纳
讨论→接洽
赴任→接事
接办→接手
担当→接受
讨论→接头
不断→接续
策应→接应
近在眉睫→接于眼前
相继→接踵
络绎不绝→接踵而来
纷至沓来→接踵而至
揭隐私→揭疮疤
逼上梁山→揭竿而起
揭破→揭露
揭发→揭破
展现→揭示
发表→揭晓
揭疮疤→揭隐私
发表→揭橥
市井→街市
市井→街市商人
陌头→街头
简略节略→节减
着着失败→节节失利
节省→节流
选录→节录
节减→节略
烈女→节女
节奏→节拍
骨气→节气
节流→节省
添枝加叶→节外生枝
结余→节余
节省→节约
节拍→节奏
挟制→劫持
劫掠→劫夺
满目荒凉→劫夺一空
大难不死→劫后余生
劫夺→劫掠
磨难→劫难
劫运→劫数
劫数→劫运
良好→杰出
佳构→杰作
明净→洁白
清洁→洁净
守身如玉→洁身自爱
明哲保身→洁身自好
了案→结案
拜把兄弟→结拜兄弟
感恩图报→结草衔环
滚存→结存
布局→结构
效果→结果
完婚→结婚
交友→结交
了局→结局
缔盟→结盟
笼络→结纳
攀亲→结亲
竣事→结束
末端→结尾
毕业→结业
节余→结余
树怨→结怨
踏实→结壮
结实→结子
及锋而试→捷足先得
及锋而试→捷足先登
移多补少→截长补短
扣留→截留
大相径庭→截然不同
判然不同→截然有异
停止→截止
削足就履→截趾适屦
削足就履→截趾适履
停止→截至
真挚→竭诚
不遗余力→竭尽全力
殚精竭虑→竭尽心思
勉力→竭力
杀鸡取卵→竭泽而渔
浇愁→解愁
排除→解除
典押铺→解当铺
开除→解雇
退役还乡→解甲归田
补救→解救
办理→解决
动身→解缆
拯民水火→解民倒悬
剖解→解剖
遣散→解散
表明→解释
讲授→解说
崩溃→解体
抒难→解危
得救→解围
剖析→解析
令弟→介弟
介意→介怀
参与→介入
先容→介绍
介怀→介意
警备→戒备
饬厉→戒勉
心病→芥蒂
定义→界说
边界→界限
假贷→借贷
借条→借单
借路→借道
托故→借端
托故→借故
鉴戒→借鉴
欠据→借据
捏词→借口
乞贷→借款
借道→借路
乞贷→借钱
借据→借券
假使→借使
倘若→借使倘使
借重→借势
拐弯抹角→借题发挥
借单→借条
借单→借约
告贷→借债
借势→借重
债主→借主
借单→借字
托词→藉词
托故→藉端
藉卉→藉槁
藉槁→藉卉
女中豪杰→巾帼须眉
女中丈夫→巾帼英雄
目前→今朝
今是昨非→今非昔比
以后→今后
本年→今年
本日→今日
此生→今生
当代→今世
昔不如今→今是昨非
本日→今天
克日→今天不日
彻夜→今夜
琐屑较量→斤斤计较
黄灿灿→金灿灿
铜墙铁壁→金城汤池
秋风→金风抽丰
暮鼓晨钟→金口木舌
莫逆交→金兰交
弓足→金莲
一统天下→金瓯无缺
款项→金钱
钱可通神→金钱万能
山盟海誓→金石之盟
细软→金饰
城开不夜→金吾不禁
锦衣玉食→金衣玉食
富可敌国→金玉满堂
玉液琼浆→金樽旨酒
滋润→津润
补助→津贴
度量→襟怀
胸怀→襟怀胸襟
心曲→襟曲
告急→紧急
牢记→紧记
牢牢→紧紧
精密→紧密
合作无懈→紧密合作
密切→紧密亲密
紧急→紧要
生死关头→紧要关头
告急→紧张
严防→谨防
服膺→谨记
审慎→谨慎
兢兢业业→谨小慎微
袖中神算→锦囊妙计
美丽→锦绣
金衣玉食→锦衣玉食
只管→尽管
只管即便→尽量
恣意→尽情
和盘托出→尽情宣露
精美绝伦→尽善尽美
满是→尽是
一览无余→尽收眼底
经心→尽心
全力以赴→尽心尽力
纵情→尽兴
效忠→尽忠
强敌→劲敌
干劲→劲头
现状→近况
迩来→近来
隔壁→近邻
比年→近年
嫡亲→近亲
克日→近日
晚世→近世
类似→近似
接于眼前→近在眉睫
前进→进步
先进→进步前辈
一日千里→进步神速
出场→进场
历程→进程
收支→进出
攻击→进犯
打击→进攻
攻击→进击
升级→进级
入口→进口
舶来品→进口货
入款→进款
朝上进步→进取
进退维谷→进退两难
进退两难→进退失据
骑虎难下→进退维谷
贡献→进献
举行→进行
学习→进修
投刺→进谒
希望→进展
积渐→浸渐
洗礼→浸礼
感化→浸染
不由得→禁不住
监禁→禁锢
不准→禁绝
克制→禁止
皮蛋→京彩
都城→京城
都门→京都
都门→京师
包办→经办
每每→经常
管理→经管
匡时济世→经国济民
颠末→经过
议决→经过议定
经书→经籍
掮客→经纪
耐久→经久
司理→经理
履历→经历
做生意→经商
担当→经受
经籍→经书
全心→经心
履历→经验
谋划→经营
经过→经由
通过→经由过程
糟糠→荆布
波折→荆棘
半壁江山→荆棘铜驼
满地荆棘→荆天棘地
哆嗦→惊怖
轰动→惊动
恐慌→惊愕
恐惧→惊骇
手忙脚乱→惊慌失措
错愕→惊惶
手足无措→惊惶失措
惊惶→惊悸
恐慌→惊惧
恐慌→惊恐
怕惧→惊怕
惊异→惊奇
齰舌→惊叹
震天动地→惊天动地
触目惊心→惊心动魄
惊奇→惊讶
惊奇→惊异
谨小慎微→兢兢业业
精炼→精辟
杰出→精采
精美→精彩
精炼→精粹
一个钱打二十四个结→精打细算
干练→精悍
英华→精华
精炼→精华精辟
精神抖擞→精力充沛
简练→精练
精粹→精炼
良好→精良
精致→精美
尽善尽美→精美绝伦
细密→精密
夺目→精明
佳构→精品
精良→精巧
博识→精深
神经病→精神病
容光焕发→精神抖擞
神采飞扬→精神焕发
萎靡不振→精神萎顿
神采奕奕→精神奕奕
醒目→精通
考究→精细精美
精通→精晓
经心→精心
字斟句酌→精益求精
风雅→精致
精干→精壮
井然有序→井井有理
井然有序→井井有条
井井有条→井然有序
鷽鸠笑鹏→井蛙语海
管中窥豹→井蛙之见
境况→景况
景致→景色
风景→景物
情形→景象
气象→景象形象
敬慕→景仰
情形→景遇
保卫→警备
警励→警策
警员→警察
告诫→警告
警语→警句
戒备→警觉
警策→警励
鉴戒→警惕
保镳→警卫
警觉→警悟
警觉→警醒
警句→警语
警察→警员
赛舟→竞渡
赛跑→竞走
镇日→竟日
祭奠→敬拜
敬重→敬服
唯命是听→敬谨如命
恪慎→敬慎
田地→境地
地步→境界
悄然默默→静静
平静→静谧
埋头→静心
默坐→静坐
梦幻泡影→镜花水月
贫乏→窘蹙
逆境→窘境
胶葛→纠缠
扳缠不清→纠缠不清
轇轕→纠葛
集合→纠合
调集→纠集
鸠率→纠率
追究→究查
盘问→究诘
真相→究竟
毕竟→究竟结果
沧海一粟→九牛一毫
地府→九泉
玄月→九月
费尽心机→久有存心
长远→久远
侍者→酒保
羽觞→酒杯
酒席→酒菜
旅店→酒店
酒肆→酒坊
花天酒地→酒绿灯红
猪朋狗友→酒肉朋友
酒坊→酒肆
醉翁→酒徒
梨涡→酒涡
酒菜→酒席
宿病→旧病
古道→旧道
老例→旧规
老例→旧例
客岁→旧年
昔日→旧日
往事→旧事
旧交→旧友
宿债→旧债
宿帐→旧帐
援军→救兵
扬汤止沸→救火投薪
消防员→救火员
济急→救急
浮水衣→救生衣
救济→救助
落网→就逮
当场→就地
请教→就教
办事→就事
便是→就是
利市→就手
停当→就绪
妥贴→就绪妥当
断送→就义
母舅→舅父
外氏→舅家
娘舅→舅舅
安不忘危→居安思危
住所→居处
高高在上→居高临下
住民→居民
宅忧→居丧
寓所→居所
故意→居心
居心不良→居心叵测
宅忧→居忧
扣押→拘留收禁
逮捕→拘系
偷袭→狙击
全心全意→鞠躬尽瘁
审问→鞠问
僻处一方→局促一隅
场合排场→局面
此中人→局内人
范围→局限
品味→咀嚼
相敬如宾→举案齐眉
碰杯→举杯
办法→举措
设施→举措措施
活动→举动
算做→举动当作
仰人鼻息→举夺由人
抬高→举高
万众一心→举国同心
百口→举家
保举→举荐
孤苦伶仃→举目无亲
孤苦伶仃→举目无亲孤芳自赏
环球→举世
旷代一人→举世无匹
独一无二→举世无双
发难→举事
昂首→举头
闻一知十→举一反三
活动→举止
落落大方→举止高雅
满堂→举座
咬文嚼字→句斟字嚼
巨子→巨擘
大奸→巨猾
富商→巨贾
富家→巨室
巨擘→巨头
大小→巨细
巨头→巨子
抗捕→拒捕
断绝→拒却
把守→拒守
脚本→剧本
戏院→剧场
大贼→剧盗
畏罪→惧罪
扼守→据守
听说→据说
占有→据有
间隔→距离
会餐→聚餐
集会→聚会会议
堆积→聚积
剥削→聚敛
离合→聚散
捐钱→捐款
捐献→捐募
捐款→捐钱
断送→捐躯
马革裹尸→捐躯疆场
救济→捐赠
炒鱿鱼→卷铺盖
香烟→卷烟
怀念→眷念
家属→眷属
关怀→眷注
分高下→决雌雄
信心→决定信念
定夺→决计
断交→决绝
断然→决然
断然→决然毅然
殊死→决死
刻意→决心
信心→决心信念
背注一掷→决一死战
决策→决议计划
定夺→决议确定
决定→决意
决斗→决战
血战→决战苦战
秘诀→诀窍
秘诀→诀要
挑剔→抉剔
决议→抉择
遗言→绝笔
悬崖→绝壁
百折不挠→绝不屈服
旷世→绝代
尽头→绝顶
闭口→绝口
死路→绝路末路
发觉→觉察
以为→觉得
掠夺→攫取
武备→军备
礼服→军服
战功→军功
号角→军号
军器→军火
兵舰→军舰
兵力→军力
军械→军器
武士→军人
智囊→军师
戎机→军事机密
羽书→军书
军火→军械
虎帐→军营
兵种→军种
戎衣→军装
平衡→均衡
均摊→均派
均派→均摊
匀称→均匀
隽拔→俊拔
豪杰→俊杰
美丽→俊丽
翘楚→俊彦
飘逸→俊逸
魁首→俊
坚辞→峻拒
严厉→峻厉
结束→竣事
洽商→卡脖子
开发→开辟
开朗→开畅
起初→开初
启发→开导
开辟→开发
开拔→开赴
建国→开国
动身→开航
着花→开花
舒怀→开怀
拓荒→开荒
弛禁→开禁
明朗→开阔爽朗
摄影机→开麦拉
引狼入室→开门揖盗
鼻祖→开山祖师
开头→开首
开顽笑→开玩笑
开玩笑→开顽笑
坦怀相待→开心见诚
开火→开仗
开门见山→开宗明义
得罪→开罪
班师→凯旅
允承→慨诺
太息→慨气
叹息→慨叹
榜样→楷模
注销→刊出
登载→刊登
改定→刊定
勘误表→刊误表
发行→刊行
勘察→勘测
订正→勘误
刊误表→勘误表
青鸟术→堪舆术
罗网→坎阱
伐木→砍木
当作→看成
看破→看穿
见机行事→看风使舵
监视→看管
关照→看护
瞥见→看见
看透→看破
把守→看守
看破→看头
看破→看透
探望→看望
病愈→康复
快乐→康乐
丰年→康年
急公好义→慷慨仗义
久旱→亢旱
拒捕→抗捕
跋山涉水→抗尘走俗
防备→抗御
考察→考查
观察→考察
科场→考场
考绩→考成
订正→考订
稽核→考核
考成→考绩
讲求→考究
考证→考据
思量→考虑
磨练→考验
评语→考语
考据→考证
登科→考中
鞭挞→拷打
可靠→靠得住
背景→靠山
酷吏→苛吏
荼毒→苛虐
考场→科场
刑罚→科罚
定罪→科罪
叩首→磕头
稳操胜券→可操左券
小大由之→可大可小
可人→可儿
能否→可否
难得→可贵
恐怖→可骇
适口→可口
大概→可能
可骇→可怕
可钦→可佩
碰巧→可巧
可佩→可钦
可儿→可人
但是→可是
可信→可托
能够→可以或许
无关紧要→可有可无
临渴掘井→渴而穿井
渴仰→渴慕
孺慕→渴念
渴望→渴想
渴慕→渴仰
降服→克服
自制→克己
剥削→克扣
即日→克日
锐意→克意
冷酷→刻毒
铭肌镂骨→刻骨铭心
画虎成犬→刻鹄类鹜
描画→刻画
受苦→刻苦
克日→刻期
期限→刻日
面前目今→刻下
客官→客长
旅舍→客店
客长→客官
旅居→客居
去年→客岁
客厅→客堂
客气→客套
客堂→客厅
堆栈→客栈
讲义→课本
讲堂→课堂
拓荒→垦荒
耕作→垦植
镌谕→恳
谋害→坑害
空缺→空白
奇策→空城计
空隙→空地
空隙→空地空闲
空腹→空肚
空匮→空乏
空屋→空房
旷日持久→空费时日
枵腹→空腹
空谈→空口说
空乏→空匮
辽阔→空阔
空话→空论
浮名→空名
氛围→空气
亘古未有→空前未有
白手→空手
空地→空位
空房→空屋
清闲→空隙
纸上谈兵→空言无补
梦幻泡影→空中阁楼
阿堵物→孔方兄
儒教→孔教
急切→孔殷
惧怕→恐惧
栗栗不安→恐惧不安
忧惧→恐忧
港口→口岸
众口称善→口碑载道
天花乱坠→口不择言
谈锋→口才
牙白口清→口齿伶俐
口授→口传
口子→口儿
供词→口供
标语→口号
黑白→口角
话柄→口实
口传→口授
口胃→口味
口味→口胃
言犹在耳→口血未干
口儿→口子
监禁→扣留
拍门→扣门
折扣→扣头
询问→扣问
干瘪→枯瘠
贫乏→枯窘
否极泰来→枯木逢春
隆替→枯荣
凋零→枯萎死亡
闲坐→枯坐
啼笑皆非→哭笑不得
洞穴→窟窿
凄凉→苦楚
苦衷→苦处
夫役→苦力
薄命→苦命
恳求→苦求
坚守→苦守
困心衡虑→苦心焦虑
激战→苦战
心事→苦衷
酷爱→酷好
苛吏→酷吏
严刑→酷刑
过甚其辞→夸大其词
美好→夸姣
放言高论→夸夸其言
浮夸→夸张
完蛋→垮台
驾返瑶池→跨鹤西归
超过→跨越
慌慌张张→快快当当
爱好→快乐喜爱
干脆爽快→快人快事
宽慰→快慰
将近→快要
广漠→宽敞豁达
豁达→宽大旷达
宽免→宽贷豁免
豁略大度→宽宏大量
央央大度→宽洪大度
宽心→宽解
威德兼施→宽猛相济
抚慰→宽慰
脱期→宽限
延接→款接
格局→款式
款子→款项
款项→款子
经国济民→匡时济世
斧正→匡正
帮助→匡助
狞恶→狂暴
怒潮→狂潮
放荡→狂放
咆哮→狂嗥
大言→狂言
杜康→狂药
痛饮→狂饮
何况→况且
举世无匹→旷代一人
空地→旷地
缺课→旷课
绝代→旷世
斗南一人→旷世一人
田野→旷野
幸亏→亏得
薄弱→亏弱
赔本→亏蚀
负心→亏心
观察→窥察
侦察→窥伺
窥伺→窥探
蒲扇→葵扇
高大→魁岸
领袖→魁首
无地自容→愧汗怍人
腐败→溃烂
崩溃→溃散
崩溃→溃逃
奉送→馈送
奉送→馈遗
奉送→馈赠
虫豸→昆虫
伯仲→昆季
后代→昆裔
手足昆季→昆玉
手足昆季→昆仲
系缚→捆扎
困窘→困顿
狐疑→困惑
逆境→困境
困顿→困窘
干瘪→困苦
包围→困绕
苦心焦虑→困心衡虑
香肠→腊肠
年近岁终→腊鼓频催
年近岁终→腊尽冬残
尾月→腊月
烛炬→蜡烛
来源→来历
到临→来临
往复→来去
翌日→来日诰日
明年→来岁
来由→来因
理由→来由
泉源→来源
本原→来源根基
玉石同烬→兰艾俱焚
兰艾俱焚→兰艾同焚
兰艾俱焚→兰艾同烬
哲人其萎→兰摧玉折
至好→兰交
梦熊→兰梦
雕栏→栏杆
衰退→阑珊
浮名→谰言
绚丽→烂漫
漂帐→烂帐
大醉→烂醉
玉山颓倒→烂醉如泥
大醉→烂醉陶醉
谰言→滥调
视如草芥→滥杀无辜
来源→滥觞
抱头鼠窜→狼狈而逃
狼狈不堪→狼狈万状
朋比为奸→狼狈为奸
一败涂地→狼奔豕突
缭乱→狼籍
散乱→狼藉
烽火→狼烟
海潮→浪潮
游荡→浪荡
游勇→浪人
浪费→浪掷
荡子→浪子
劳累→劳顿
功劳→劳绩
屈驾→劳驾
犒军→劳军
费神→劳神
牢固→牢靠
樊笼→牢笼
怨气冲天→牢骚满腹
监狱→牢狱
老年得子→老蚌生珠
敦朴→老诚
老练→老到
老汉→老夫
老太婆→老妇人
老例子→老规矩
老夫→老汉
山君→老虎
叫花子→老花子
故乡→老家
宿将→老将
晚景→老景
惯例→老例
老规矩→老例子
老大→老迈
老僧→老衲
老蚌生珠→老年得子
暮年→老年末年
妻子→老婆
老着脸子→老起面皮
暮气→老气
翻戏→老千
夙儒→老儒
老衲→老僧
古井不波→老僧入定
老小→老少
童叟无欺→老少无欺
须生→老生
旧调重弹→老生常谈
总是→老是
人老珠黄→老树枯柴
老妇人→老太婆
老少→老小
大发雷霆→老羞成怒
尸居余气→老朽无能
好友→老友
老朽→老拙
老起面皮→老着脸子
告成→乐成
乐不思蜀→乐而忘返
乐师→乐工
兴尽悲来→乐极生悲
音律→乐律
曲谱→乐谱
兴趣→乐趣
乐陶陶→乐融融
乐工→乐师
丰年→乐岁
乐滋滋→乐陶陶
安分守己→乐天知命
乐园→乐土
高兴→乐意
乐土→乐园
乐陶陶→乐滋滋
迫令→勒令
胁迫→勒迫
打单→勒索
排山倒海→雷霆万钧
类似→雷同
胸膜→肋膜
泪如泉涌→泪流满面
泪流满面→泪如泉涌
泪流满面→泪如雨下
泪流满面→泪眼汪汪
种别→类别
雷同→类似
范例→类型
危如累卵→累卵之危
淡漠→冷淡
凉风→冷风
寒光→冷光
寒害→冷害
盗汗→冷汗
暗箭→冷箭
岑寂→冷静
冷漠→冷酷
荒凉→冷落
冰脸→冷面
淡漠→冷漠
心里有数→冷暖自知
冷酷→冷峭
冷静→冷清
漠视→冷视
寒天→冷天
小巷→冷巷
嘲笑→冷笑
隔岸观火→冷眼旁观
馂余→冷炙
变革→厘革
酒涡→梨涡
戏班→梨园
戏剧演员→梨园子弟
分别→离别
隔开→离隔
聚散→离合
悲欢离合→离合悲欢
仳离→离婚
诽谤→离间
脱离→离开
古怪→离奇
拜别→离去
孤苦伶仃→离群索居
分离→离散
退席→离席
尔虞我诈→离心离德
仳离→离异
去职→离职
直捣黄龙→犁庭扫穴
百姓→黎民
平明→黎明
竹篱→篱笆
星期→礼拜
礼制→礼法
制服→礼服
弁冕→礼帽
规矩→礼貌
礼物→礼品
聘请→礼聘
谦逊→礼让
投桃报李→礼尚往来
会堂→礼堂
礼品→礼物
礼节→礼仪
礼法→礼制
内里→里面
行家→里手
答理→理睬
召唤→理睬呼唤
该当→理当
天经地义→理当如此
剃头→理发
剖析→理会
明白→理解
明白→理解理睬
默不作声→理屈词穷
天经地义→理所当然
抱负→理想
来由→理由
利巴→力把
力有未逮→力不从心
力难胜任→力不胜任
孔武有力→力大无穷
力不胜任→力难胜任
脚钱→力钱
力图→力求
力争上游→力求进步
力求进步→力求上进
力衰→力弱
力弱→力衰
无能为力→力所不及
入木三分→力透纸背
力求→力图
力求进步→力图上进
力不从心→力有未逮
力图→力争
力求上进→力争上流
力图上进→力争上游
通书→历本
进程→历程
饱经风霜→历尽沧桑
赴汤蹈火→历尽艰险
含辛茹苦→历尽艰辛
长期→历久
向来→历来
绘声绘影→历历如绘
念念不忘→历历在目
积年→历年
汗青→历史
盛食厉兵→厉兵秣马
锋利→厉害
严容→厉色
备案→立案
态度→立场
树德→立德
马上→立地
学富五车→立地书橱
取得根据→立定脚跟
吹糠见米→立杆见影
吹糠见米→立竿见影
建功→立功
立即→立刻
扬名→立名
立身→立品
立品→立身
马上→立时
结婚→立室
发誓→立誓
傲岸→立崖岸
创新→立异
发愤→立志
弹丸之地→立锥之地
驻足→立足
富丽→丽都
美人→丽人
力把→利巴
方便→利便
好坏→利害
白→利剑
忘恩负义→利令智昏
爽利→利落
痛快→利落索性
利息→利钱
芒刃→利刃
亨通→利市
获利优厚→利市三倍
利钱→利息
长处→利益
独享权益→利益均沾
使用→利用
迷惑→利诱
自私自利→利欲熏心
丹诚相许→沥胆披肝
歃血为盟→沥血以誓
比方→例如
破例→例外
官样文章→例行公事
从属→隶属
恐惧不安→栗栗不安
庸庸碌碌→栗六庸才
趁热打铁→连成一气
团结→连合
毗连→连接
保持→连结
连系→连络
赶快→连忙
比年→连年
连续→连气儿
蝉联→连任
结合→连系
一连→连续
接二连三→连续不断
连珠炮→连珠箭
连珠箭→连珠炮
连绵→连缀
恻隐→怜悯
痛惜→怜惜
悯恤→怜恤
荡漾→涟漪
双宿双飞→莲开并蒂
连绵→联贯
团结→联合
联姻→联婚
团结→联结
联结→联络
携手→联袂
同盟→联盟
关联→联系关系
遐想→联想
攀亲→联姻
耿介→廉洁
囊空如洗→廉洁奉公
廉明→廉正
面庞→脸蛋
酡颜→脸红
面颊→脸颊
面目→脸孔
面庞→脸庞
表情→脸色
实习→练习
养成工→练习生
演练→练习训练
冶坊→炼坊
爱情→恋爱
依依不舍→恋恋不舍
羡慕→恋慕
情人→恋人
佳偶→良伴
善策→良策
良伴→良俦
很多→良多
精良→良好
很久→良久
名厨→良庖
良友→良朋
夫君→良人
和睦→良善
吉人→良士
美计→良图
良夜→良宵
本心→良心
忠言逆耳→良药苦口
良宵→良夜
良朋→良友
龙蛇混杂→良莠淆杂
知己→良知
冷风→凉风
风凉→凉快
草帽→凉帽
冷气→凉气
双方→两边
两头→两端
南北极→两极
立地书橱→两脚书橱
泪流满面→两泪汪汪
口是心非→两面三刀
分身→两全
一箭双鵰→两全其美
两端→两头
青梅竹马→两小无猜
秦晋之好→两姓之好
秦晋之好→两姓之欢
囊空如洗→两袖清风
泪如泉涌→两眼汪汪
光亮→亮光
表态→亮相
实事求是→量力而行
看风使舵→量体裁衣
迢遥→辽远
调理→疗养
谈天→聊天
寂寥→寥寂
寥寥无几→寥寥可数
寥若晨星→寥寥无几
零落→寥落
寥寥无几→寥若晨星
撩蜂剔蝎→撩蜂拨刺
撩蜂拨刺→撩蜂剔蝎
星火燎原→燎原之火
桎梏→镣铐
结案→了案
了不起→了不得
了不得→了不起
偿还→了偿
告终→了结
相识→了解
结果→了局
明晰→了了
了结→了却
明了→了然
洞若观火→了如指掌
远望→了望
清偿→了债
推测→料到
摒挡→料理
臆则屡中→料事如神
意料→料想
猜中→料中
传记→列传
排队→列队
各国→列国
枚举→列举
参加→列入
各位→列位
排阵→列阵
下等→劣等
次货→劣货
败行→劣行
猛火→烈火
节女→烈女
骄阳→烈日
火伞高张→烈日当空
义士→烈士
炎火→烈焰
缝隙→裂缝
毗邻→邻接
相近→邻近
邻人→邻居
邻居→邻人
各式各样→林林总总
临机应变→临机处置
临机处置→临机应变
江心补漏→临渴掘井
摹仿→临摹
生产→临盆
分娩→临蓐
暂时→临时
见义勇为→临危不惧
临渴掘井→临阵磨枪
极尽描摹→淋漓尽致
洋火→磷寸
鬼火→磷火
麋集→鳞集
皮开肉绽→鳞伤遍体
拾零→鳞爪
凛凛→凛冽
凛冽→凛凛
鄙吝→吝啬
守财奴→吝啬鬼
怜惜→吝惜
孤苦→伶丁
孤独→伶仃
聪明→伶俐
戏子→伶人
灵巧→灵便
灵柩→灵榇
灵活→灵动
魂魄→灵魂
灵榇→灵柩
机灵→灵巧
通达→灵通
仙丹→灵药
破晓→凌晨
高出→凌驾
缭乱→凌乱
虐待→凌虐
欺凌→凌辱
志薄云霄→凌云壮志
陵虐→陵暴
侵陵→陵犯
陵暴→陵虐
陵园→陵寝
衰微→陵夷
陵寝→陵园
单独→零丁
庞杂→零乱
寥落→零落
凋零→零落凋落
零星→零散
琐屑→零碎
零散→零星
工头→领班
向导→领导
引港→领港
了解→领会
围巾→领巾
明白→领略
承情→领情
接收→领受
意会→领悟
首脑→领袖
掌珠→令嫒
驷不及舌→令出必行
令出必行→令出如山
令正→令阃
公子→令郎
怒不可遏→令人发指
不共戴天→令人切齿
引人入胜→令人着迷
令婿→令坦
令坦→令婿
千金→令媛
令阃→令正
别开生面→另具匠心
重新努力别辟门户→另起炉灶
再娶→另娶
他日→另日
别的→另外
刮目相看→另眼相看
尚有→另有
滑冰→溜冰
漫步→溜达
抱头鼠窜→溜之大吉
弊端→流弊
流通→流畅
活动→流动
弊端→流毒
千古流芳→流芳百世
万古长青→流芳千古
放逐→流放
流离→流浪
堕泪→流泪
流浪→流离
颠沛流离→流离失所
颠沛流离→流离转徙
乐不思蜀→流连忘返
表露→流露
显露表露→流露透露
漂泊→流落
地痞→流氓
灾民→流民
派别→流派
飘泊→流散
流畅→流通
避难→流亡
盛行→流行
传染病→流行症
浮名→流言
飞短流长→流言蜚语
停步→留步
保存→留存
包涵→留情
蝉联→留任
留意→留神
过夜→留宿
把稳→留心
把稳→留意
鸟语花香→柳绿桃红
杏眼圆睁→柳眉倒竖
一乾二净→六根清净
天地→六合
魂飞魄散→六神无主
家畜→六畜
鸾翔凤翥→龙飞凤舞
龙章凤姿→龙凤之姿
生龙活虎→龙精虎猛
龙腾虎跃→龙马精神
冰片→龙脑
泥沙俱下→龙蛇混杂
龙马精神→龙腾虎跃
龙凤之姿→龙章凤姿
覆盖→笼盖
包围→笼罩
寒冬→隆冬
砰然→隆然
兴盛→隆盛
枯荣→隆替
鸿运→隆运
谨慎→隆重
把持→垄断
黑钱→陋规
浅薄→陋劣
俗儒→陋儒
鄙俗→陋俗
蓬门→陋屋
成规→陋习
僻巷→陋巷
泄电→漏电
遗漏→漏掉
毛病→漏洞
丧家之犬→漏网之鱼
暴露→露出
出漏洞→露马脚
露珠→露水
风尘仆仆→露宿风餐
天台→露台
露水→露珠
出神入化→炉火纯青
粗鲁→卤莽
抢劫→掳掠
呆笨→鲁钝
卤莽→鲁莽
冒失鬼→鲁莽汉
和事老→鲁仲连
连续→陆续
登科→录取
灌音→录音
任命→录用
比翼双飞→鹿车共勉
夫唱妇随→鹿车共挽
凑数其间→碌碌无为
旅程→路程
盘费→路费
途经→路过
门路→路线
途径→路子
勉力→戮力
合力攻敌→戮力同心
牛头不对马嘴→驴唇不对马嘴
狗仗人势→驴蒙虎皮
路程→旅程
旅馆→旅店
盘缠→旅费
旅店→旅馆
客居→旅居
游客→旅客
旅店→旅舍
旅店→旅社
观光→旅行
巡回剧团→旅行剧团
频频→屡次
家常便饭→屡见不鲜
频频→屡屡
经历→履历
赴任→履新
推行→履行
践言→履言
如约→履约
法规→律例
状师→律师
轻率下笔→率尔操觚
天下归心→率土归心
普天同庆→率土同庆
任性→率性
萧规曹随→率由旧章
坦白→率直
忘八乌龟无赖→绿头巾
蛋白→卵白
椭圆形→卵形
庇护→卵翼
乱撞→乱闯
乱用→乱花
瞎搅→乱来
漫骂→乱骂
七零八落→乱七八糟
浊世→乱世
胡说→乱说
乱花→乱用
乱闯→乱撞
打劫→掠夺
拂面→掠面
抢夺→掠取
小坐→略坐
沉溺堕落→沦落
沦陷→沦亡
陷落→沦陷
汽船→轮船
轮替→轮番
循环→轮回
表面→轮廓
轮番→轮流
轮番→轮替
照功行赏→论功行赏
讲价→论价
名学→论理学
叙述→论述
论述→论说
议论文→论说文
有夫之妇→罗敷有夫
吃尽当光→罗掘俱穷
摆列→罗列
坎阱→罗网
汲取→罗致
名学→逻辑学
侦骑→逻骑
赤身→裸体
不断→络续
继续不停→络绎不绝
完工→落成
落选→落第
出家→落发
屁滚尿流→落花流水
跌价→落价
雪上加霜→落井下石
失去→落空
题名→落款
举止高雅→落落大方
凋零→落莫
流浪→落难
崎岖潦倒→落魄
夕阳→落日
悠闲→落拓
不拘小节→落拓不羁
就逮→落网
落第→落选
夏布→麻布
贫苦→麻烦
镇痛剂→麻醉剂
快马加鞭→马不停蹄
时光虚掷→马齿徒增
旗开马到→马到成功
骑兵→马队
战死沙场→马革裹尸
敷衍→马虎
敷衍了事→马马虎虎
顿时→马上
密切追随→马首是瞻
胡匪→马贼
船埠→码头
匿伏→埋伏
隐藏→埋没
笃志→埋头
大班→买办
交易→买卖
认真→卖力
矫饰→卖弄
笔耕墨耘→卖文为活
蜗角之争→蛮触之争
霸道→蛮横
强词夺理→蛮横无理
刁话→蛮话
生番→蛮人
夷狄→蛮夷
荆天棘地→满地荆棘
愁肠百结→满腹忧愁
恒河沙数→满坑满谷
劫夺一空→满目荒凉
浑身→满身
全是→满是
得意→满意
弥漫→满盈
万无一失→满有把握
餍足→满足
诅咒→谩骂
轻慢→慢待
逐步→慢慢
随笔→漫笔
闲步→漫步
长空→漫空
会谈→漫谈
得陇望蜀→漫无止境
散布→漫衍
弥漫→漫溢
周游→漫游
伸张→蔓延
如坐针毡→芒刺在背
利刃→芒刃
草鞋→芒鞋
瞽者→盲人
瞎眼→盲眼
不得要领→茫无头绪
羊毫→毛笔
弊端→毛病
不寒而栗→毛骨悚然
慌脚鸡→毛姜
自我介绍→毛遂自荐
抵牾→矛盾
厕所→茅厕
茅屋→茅舍
茅舍→茅屋
向荣→茂发
繁盛→茂盛
假冒→冒充
得罪→冒犯
造次→冒昧
招摇撞骗→冒名行骗
鲁莽→冒失
失魂鱼→冒失鬼
搏命→冒死
同床异梦→貌合神离
寝陋→貌寝
似是而非→貌同实异
灭顶→没顶
没关系→没紧要
灰心丧气→没精打彩
消灭→没落
籍籍无名→没没无闻
败兴→没趣
充公→没收
劈头盖脸→没头没脑
罗列→枚举
欢天喜地→眉飞色舞
眉飞色舞→眉开眼笑
端倪→眉目
眼去眉来→眉目传情
初月→眉月
婢女→梅香
前言→媒介
牙婆→媒婆
媒妁→媒人
媒人→媒妁
汽油灯→煤汽灯
火油→煤油
日就衰败→每况愈下
通常→每每
逐日→每日
时时刻刻→每时每刻
妍媸→美丑
优美→美好
良图→美计
琼浆→美酒
竹苞松茂→美轮美奂
完满→美满
曲终奏雅→美满收场
仙颜→美貌
好梦→美梦
隽誉→美名
美女→美男
玉人→美女
尤物→美人
命薄如花→美人命薄
丹青妙手→美术大师
佳话→美谈
鲜味→美味
盛情→美意
佳誉→美誉
狐媚→媚惑
家世→门第
家声→门风
齐大非偶→门高莫对
流派→门户
办法→门径
食客→门客
弟子→门生
华盖云集→门庭若市
徒弟→门徒
外行人→门外汉
忽忽不乐→闷闷不乐
抽芽→萌芽
友邦→盟国
牛耳→盟主
烈火→猛火
虎将→猛将
大进→猛进
剧烈→猛烈
蓦地→猛然
痛饮→猛饮
无知→蒙昧
遭受→蒙受
梦呓→梦话
空中阁楼→梦幻泡影
梦乡→梦境
求之不得→梦寐以求
梦境→梦乡
空想→梦想
梦话→梦呓
垂危→弥留
含糊→迷糊
利诱→迷惑
渺茫→迷茫
失路→迷途
觉返迷津→迷途知反
答案→谜底
糜掷→糜费
糜费→糜掷
腐败→靡烂
濮上之音→靡靡之音
赡养费→米饭钱
木已成舟→米已成炊
孤本→秘本
秘而不泄→秘而不露
秘而不宣→秘而不泄
秘而不泄→秘而不宣
秘籍→秘笈
秘笈→秘籍
法门→秘诀
私相授受→秘密交易
盖世太保→秘密警察
底细→秘闻
春宫→秘戏图
机密→秘要
探听→密查
告发→密告
麋集→密集
暗码→密码
密密丛丛→密密层层
密密层层→密密丛丛
谋害→密谋
亲昵→密切
马首是瞻→密切追随
密屋→密室
女士→密斯
密室→密屋
深情→密意
好友→密友
私语→密语
小姐→蜜斯
深情→蜜意
甜言→蜜语
横亘→绵亘
薄材→绵力
绵力→绵力薄材
源源不绝→绵绵不断
免去→免除
省得→免得
免除→免去
省掉→免却
夺职→免职
赦罪→免罪
努力→勉力
委曲→勉强
惦记→缅怀
缅怀→缅想
面临→面对
脸颊→面颊
面对→面临
面目→面貌
八面见光→面面俱到
八面见光→面面俱圆
面貌→面目
言语无味→面目可憎
面孔→面目面貌
面目一新→面目全非
焕然一新→面目一新
面容→面庞
眼前→面前
目下→面前目今
面色苍白→面青唇白
面目面貌→面容
面如死灰→面如土色
面无人色→面色苍白
口试→面试
面色苍白→面无人色
体面→面子
描绘→描画
形貌→描摹
形貌→描述
形貌→描写
对准→瞄准
深奥无极→渺不可测
迷茫→渺茫
眇小→渺小
鄙视→藐视
细小→藐小
巧计→妙策
奇策→妙计
技能→妙技
妙选→妙简
二八佳人→妙龄少女
能手→妙手
药到回春→妙手回春
神算→妙算
趣闻→妙闻
胡思乱想→妙想天开
妙简→妙选
灵药→妙药
趣话→妙语
谈笑风生→妙语横生
妙语连珠→妙语解颐
妙语连珠→妙语如珠
山门→庙门
古刹→庙宇
溺死→灭顶
灭绝→灭尽
灭尽→灭绝
死亡→灭亡
鄙视→蔑视
民俗→民风
大众文学→民间文学
民心→民气
国困民艰→民穷财尽
百孔千疮→民生凋敝
民风→民俗
民气→民心
大快人心→民怨沸腾
国蠹→民贼
哀怜→悯恻
矜恤→悯恤
名存实亡→名不副实
良庖→名厨
名不副实→名存实亡
豁然开朗→名顿开
树大招风→名高引谤
求名求利→名利双收
压倒一切→名列前茅
名士→名流
王谢→名门
款式→名目
名流→名人
胜景→名胜
名流→名士
名誉→名望
论理学→名学
光荣→名誉
臭名昭着→名誉扫地
声誉鹊起→名震一时
光明正大→名正言顺
彰明较着→明白昭彰
是非分明→明辨是非
明目张胆→明火执仗
明鉴万里→明见万里
明见万里→明鉴万里
洁白→明净
洞烛奸邪→明镜高悬
清朗→明朗
豁亮→明亮
清朗→明亮清明
明白→明了
妖冶→明媚
闪动→明灭
明显→明明
明火执仗→明目张胆
来岁→明年
冥具→明器
明争暗斗→明枪暗箭
嫡→明日
时过境迁→明日黄花
昭示→明示
来日诰日→明天
来日→明天将来
明了→明晰
显着→明显
一尘不染→明哲保身
明枪暗箭→明争暗斗
州官放火→明知故犯
销声匿迹→鸣金收兵
刻骨铭心→铭肌镂骨
念念不忘→铭心镂骨
美人命薄→命薄如花
下令→命令
定名→命名
生不逢辰→命途多舛
偃蹇困穷→命途坎坷
运气→命运
偃蹇困穷→命运坎坷
运气→命运运限
掷中→命中
错爱→谬爱
乖谬→谬妄
不对→谬误
丝毫不爽→谬误百出
仿照→模仿
含糊→模糊
含糊其词→模棱两可
模子→模型
样子容貌→模样
状貌→模样形状
模型→模子
敬拜→膜拜
漂亮→摩登
技痒→摩拳擦掌
抖擞精神→磨砺以须
检验→磨练
锻炼→磨炼
消逝→磨灭
苦难→磨难
水滴石穿→磨铁成针
磨难→磨折
邪术→魔法
妖怪→魔鬼
苦难→魔难
把戏→魔术
勾消→抹煞
末了→末端
小节→末节
着末→末了
恼→末路
季世→末世
末端→末尾
街头→陌头
难道→莫非
金兰交→莫逆交
漫不经心→漠不关心
置若罔闻→漠然置之
鄙视→漠视
书生→墨客
茶青→墨绿
抱残守缺→墨守成规
默默无言→默不作声
冷静→默默
默不作声→默默无言
缄默→默然
表示→默示
心算→默算
静坐→默坐
图利→牟利
密谋→谋害
盘算→谋略
碰面→谋面
钻营→谋求
行刺→谋杀
找事→谋事
人定胜天→谋事在人
或人→某人
母钱→母财
母老虎→母大虫
母仪→母范
娘舅→母舅
母大虫→母老虎
母财→母钱
丁忧→母丧
母范→母仪
木料→木材
木料→木柴
木排→木筏
木匠→木工
目瞪口呆→木鸡之呆
木工→木匠
木柴→木料
木筏→木排
铁石心肠→木人石心
柴炭→木炭
板屋→木屋
桂花→木樨
星期四→木曜日
米已成炊→木已成舟
胸无点墨→目不识丁
目无流视→目不邪视
聚精会神→目不斜视
目不斜视→目不转睛
目录→目次
理屈词穷→目瞪口呆
眼见→目睹
目光如豆→目光短浅
目光如炬→目光如电
孤陋寡闻→目光如豆
目光如电→目光如炬
眼见→目击
过目成诵→目即成诵
不可一世→目空四海
目中无人→目空一切
目空一切→目空一世
视力→目力
眼力→目力眼光
目次→目录
眼花撩乱→目迷五色
现在→目前
见闻习染→目染耳濡
目染耳濡→目擩耳染
目若悬珠→目若朗星
目空一切→目若无人
目若朗星→目若悬珠
陌生→目生
目指气使→目使颐令
手挥目送→目送手挥
眉目传情→目挑心招
目无王法→目无法纪
目不邪视→目无流视
目无法纪→目无王法
目空一切→目无余子
面前目今→目下
现在→目下当今
一目十行→目下十行
眼花→目炫
眼花→目眩
目眩神迷→目眩魂摇
目眩魂摇→目眩神驰
目眩魂摇→目眩神迷
目眩魂摇→目眩神摇
目眩魂摇→目眩心花
目使颐令→目指气使
目空一切→目中无人
农歌→牧歌
召募→募集
坟场→墓地
尸骨早寒→墓木已拱
金口木舌→暮鼓晨钟
晚景→暮景
晚景→暮景暮年
老年末年→暮年
死气→暮气
灰心丧气→暮气沉沉
深秋→暮秋
打定主意→拿定主意
特长→拿手
那边→哪里
要地本地→内地
内在→内涵
内乱→内哄
忸怩→内疚
内中→内里
要地本地→内陆
内→内乱
黑幕→内幕
水落石出→内情毕露
内子→内人
自察→内省
阁房→内室
表里→内外
心田→内心
忧心忡忡→内心不安
老手→内行
亵服→内衣
内涵→内在
内乱→内争
内里→内中
内人→内助
内人→内子
内争→内
那里→那边
那边→那处
那边→那儿
那处→那儿那边
谁人→那个
那边→那里
那处→那里那边
当时→那时
娶妾→纳宠
享福→纳福
进贡→纳贡
受贿→纳贿
乘凉→纳凉
烦闷→纳闷
以致→乃至
小名→奶名
若何怎样→奈何
历久→耐久
刻苦→耐劳
耐烦→耐性
男子汉大丈夫→男儿膝下有黄金
男子→男人
夫君→男子
男儿膝下有黄金→男子汉大丈夫
两极→南北极
南方→南边
南边→南方
熏风→南风
黄粱一梦→南柯一梦
背道而驰→南辕北辙
出生入死→南征北战
难过→难熬
难受→难熬难过
难受→难熬痛苦
难过→难得
难明→难懂
不分高下→难分轩轾
惆怅→难过
难明→难解
难过→难堪
丢脸→难看
不免→难免
灾黎→难民
栖流所→难民营
难懂→难明
藕断丝连→难舍难分
困难→难题
刺耳→难听
刺耳→难听逆耳
瞠乎其后→难望项背
一丘之貉→难兄难弟
无法计算→难以估计
委决不下→难以决断
不可思议→难以想象
床头金尽→囊空如洗
席卷→囊括
瓮中鳖→囊中物
末路→恼
愤恨→恼恨
大发雷霆→恼羞成怒
脑壳→脑袋
脑袋→脑壳
大腹便便→脑满肠肥
脑筋→脑子
打饥荒→闹饥荒
繁盛→闹热
喧闹→闹热热烈繁华
生事→闹事
叫嚣→呐喊
期艾→呐呐
新苗→嫩芽
可否→能否
醒目→能干
可以或许→能够
本领→能力
舌粲莲花→能言善辩
泥坑→泥淖
杳无音信→泥牛入海
牛骥同皂→泥沙俱下
顼首→泥首
泥淖→泥塘
土壤→泥土
塑像→泥像
不共戴天→你死我活
订定→拟订
制定→拟定
刺耳→逆耳
窘境→逆境
唾面自干→逆来顺受
抗命→逆命
埋伏→匿伏
没顶→溺毙
灭顶→溺死
渎职→溺职
平滑→腻滑
寻花问柳→拈花惹草
年景→年成
年龄→年齿
年头→年初
年月→年代
年末→年底
德高望重→年高德劭
年终→年关
光阴→年光
韶华→年光光阴
光阴→年华
腊尽冬残→年近岁迫
腊鼓频催→年近岁终
大哥→年老
年事→年龄
年老→年迈
年底→年末
手轻脚健→年轻力壮
绮年玉貌→年轻貌美
幼年→年少
年湮代远→年深日久
积年累月→年深月久
年岁→年事
年纪→年数
年龄→年岁
年初→年头
年末→年尾
年深日久→年湮代远
大→年夜
少不更事→年幼无知
年代→年月
年末→年终
摈除→撵走
念经→念佛
念佛→念经
念兹在兹→念念不忘
读书→念书
动机→念头
念念不忘→念兹在兹
外家→娘家
母舅→娘舅
变成→酿成
兔死狗烹→鸟尽弓藏
莺啼燕语→鸟语花香
借口→捏词
宁死不屈→宁当玉碎
太平→宁靖
平静→宁静
宁肯→宁可
宁愿→宁肯
放心→宁神
不屈不挠→宁为玉碎
甘心→宁愿
狂暴→狞恶
奸笑→狞笑
凝望→凝睇
凝集→凝固
固结→凝结
凝思→凝神
谛视→凝视
凝神→凝思
凝视→凝望
大材小用→牛鼎烹鸡
盟主→牛耳
泥沙俱下→牛骥同皁
泥沙俱下→牛骥同皂
草木不生→牛山濯濯
驴唇不对马嘴→牛头不对马嘴
寒门饮恨→牛衣对泣
豪饮→牛饮
九牛一毫→牛之一毛
摇摆→扭捏
旋转→扭转
屯子→农村
农人→农夫
牧歌→农歌
庄家→农户
田舍→农家
田舍郎→农家子
耕具→农具
夏历→农历
农人→农民
农民→农人
稼穑→农事
浓郁→浓烈
冶艳→浓艳
浓厚→浓郁
彤云→浓云
盛饰→浓妆
浓装艳裹→浓妆艳抹
浓妆艳抹→浓装艳裹
饭桶→脓包
玩法→弄法
挑拨是非→弄狗相咬
拈花惹草→弄柳拈花
衖堂→弄堂
赏月→弄月
梦熊→弄璋
仆众→奴婢
仆从→奴才
仆从→奴隶
奴婢→奴仆
卑视→奴视
卑躬屈膝→奴颜婢色
卑躬屈膝→奴颜婢膝
卑躬屈膝→奴颜媚骨
高兴→努力
瞪眼→努目
大肆咆哮→怒不可遏
狂潮→怒潮
气鼓鼓→怒冲冲
拊膺切齿→怒发冲冠
肝火→怒火
拊膺切齿→怒火万丈
拊膺切齿→怒火中烧
瞋目→怒目
肝火→怒气
怒气冲发→怒气冲冲
怒气冲冲→怒气冲发
拊膺切齿→怒气冲天
瞪眼→怒视
大发雷霆→怒形于色
女侍→女婢
脂粉气→女儿态
歌女→女乐
女优→女伶
婢女→女仆
铁娘子→女强人
密斯→女士
女婢→女侍
半子→女婿
女伶→女优
女中丈夫→女中豪杰
女中豪杰→女中丈夫
荼毒→虐待
暴政→虐政
火锅→暖锅
温和→暖和
搬动→挪动转移
调用→挪用
信誉→诺言
西化→欧化
泰西→欧美
吐逆→呕吐
费尽心血→呕心沥血
偶然→偶尔
逢场作戏→偶一为之
难舍难分→藕断丝连
爬下→趴下
爬行动物→爬虫类
登山→爬山
趴下→爬下
自由式泳法→爬泳
畏惧→怕惧
害臊→怕羞
击节称赏→拍案叫绝
泅水→拍浮
捧臭脚→拍马屁
打门→拍门
鼓掌→拍手
照相→拍照
拍案叫绝→拍桌惊叹
倘佯→徘徊
彷徨歧途→徘徊歧路
场面→排场
排挤→排出
清除→排除
列队→排队
排挤→排击
倾轧→排挤
排演→排练
分列→排列
排解→排遣
翻江倒海→排山倒海
推门→排闼
分泌→排泄
排练→排演
付梓→排印
列阵→排阵
牌楼→牌坊
牌坊→牌楼
派司→牌照
流派→派别
调派→派遣
牌照→派司
气魄→派头
攀援→攀附
攀龙趋凤→攀高接贵
攀龙附凤→攀高结贵
扳话→攀话
接贵攀高→攀龙附凤
攀龙趋凤→攀龙附凤趋炎附势
阿谀奉承→攀龙趋凤
联姻→攀亲
交谈→攀谈
攀附→攀援
遮道挽留→攀辕卧辙
剥削→盘剥
盘问→盘查
旅费→盘缠
旅费→盘缠盘川
盘费→盘川
盘货→盘点
箕踞→盘蹲
盘缠→盘费
旅费→盘费盘川
心如乱麻→盘根错节
徘徊→盘桓
掘客→发掘
盘问→盘诘
分裂→盘据
盘问→盘考
拨弄→盘弄
过人才略→盘盘大才
曲折→盘曲
谋略→盘算
估计打算→盘算推算
查问→盘问
般游→盘游
剖判→判辨
鉴别→判别
判语→判词
鉴定→判定
果断→判断
讯断→判决
辨别→判袂
截然不同→判然不同
判词→判语
兵变→叛乱
反叛→叛逆
盼望→盼愿
巨大→庞大
硕大无朋→庞大无比
白发银须→庞眉皓发
繁芜→庞杂
阁下→旁边
观看→旁观
歪路→旁门
拐弯抹角→旁敲侧击
不可一世→旁若无人
引经据典→旁征博引
干证→旁证
抛撇→抛摆
抱头鼠窜→抛戈弃甲
荒疏→抛荒
抛摆→抛撇
扬弃→抛弃
撇清→抛清
放弃→抛却
投掷→抛掷
爆仗→炮竹
粉墨登场→袍笏登场
跑码头→跑江湖
赛马→跑马
跑江湖→跑码头
仆欧→跑堂
沏茶→泡茶
伴随→陪伴
随侍→陪侍
告罪→陪罪
培植→培育提拔
培养→培育种植提拔
补偿→赔偿
赔罪→赔礼
谢罪→赔罪
佩戴→佩带
佩带→佩戴
敬佩→佩服
厢房→配房
共同→配合
副角→配角
背景→配景
夫妇→配偶
配偶→配头
药剂师→配药师
设置装备摆设→配置
香→喷鼻
喷鼻→喷鼻香
歕饭→喷饭
喷鼻香→喷香
反攻→抨击
进犯→抨击打击
隆然→砰然
烹饪→烹调
烹调→烹饪
通同作恶→朋比为奸
朋友→朋侪
分割→朋分
朋侪→朋友
澎湃→彭湃
蓬发→蓬葆
蓬门→蓬荜
发达→蓬勃
隐士→蓬菖人
蓬葆→蓬发
蓬菖人→蓬户士
蓬瀛仙境→蓬莱仙境
陋屋→蓬门
披头散发→蓬首垢面
蓬葆→蓬头
头童齿豁→蓬头历齿
蓬莱仙境→蓬瀛仙境
前途似锦→鹏程万里
鸿猷→鹏图
汹涌→澎湃
恭维→捧场
拍马屁→捧臭脚
抱头→捧首
抱头→捧头
端住→捧住
举杯→碰杯
碰壁→碰鼻
碰钉子→碰壁
碰鼻→碰钉子
遇见→碰见
碰巧→碰劲
谋面→碰面
可巧→碰巧
见面→碰头
试试看→碰运气
碰到→碰着
驳倒→批驳
修正→批改
偷天换日→批红判白
资源→资本
批驳→批判
品评→批评
指挥→批示
讲明→批注
答应→批准
披散→披垂
散发→披发
丹成相许→披肝沥胆
披荆斩棘→披荆棘
披荆棘→披荆斩棘
披阅→披览
表露→披露
拖麻拽布→披麻带孝
披垂→披散
去伪存真→披沙拣金
披星带月→披霜冒露
蓬首垢面→披头散发
披星戴月→披星带月
栉风沐雨→披星戴月
披览→披阅
劈腿→劈叉
劈头→劈脸
扑面→劈面
开端→劈头
没头没脑→劈头盖脸
劈头→劈头劈脸
劈叉→劈腿
轰隆→霹雷
轰隆→霹雳
闪电战→霹雳战
京彩→皮蛋
皮囊→皮郛
十指尖尖→皮娇肉嫩
遍体鳞伤→皮开肉绽
皮郛→皮囊
表面→皮相
连接→毗连
连接→毗邻
疲惫→疲钝
疲惫→疲顿
怠倦→疲乏
疲乏→疲倦
疲惫→疲困
委顿→疲劳
拖沓→疲塌
性情→脾气
脾气→脾性
夫妇→匹俦
对抗→匹敌
血气之勇→匹夫之勇
匹马只轮→匹马不还
单人独马→匹马单枪
匹马不还→匹马只轮
劈头→匹面
立室→匹配
片甲不留→屁滚尿流
局促一隅→僻处一方
僻事→僻典
平静→僻静
僻典→僻事
穷巷→僻巷
比方→譬喻
屁滚尿流→片甲不留
半晌→片刻
单方面→片面
片面之言→片面之词
片面之词→片面之言
片刻→片霎
片刻→片晌
片刻→片时
一语而解→片言立决
一鳞半爪→片纸只字
电影→片子
偏幸→偏爱
毛病→偏差
包庇→偏护
过火→偏激
私见→偏见
冷僻→偏僻
左袒→偏袒
偏心→偏疼
方向→偏向
偏爱→偏心
偏心→偏幸
曲说→偏言
侧重→偏重
诈财→骗财
哄人→骗人
流落→漂泊
飘零→漂荡
漂泊→漂浮
漂泊→漂流
烂帐→漂帐
流浪→飘泊
飞舞→飘动
飘荡→飘零
流浪→飘流
秋蓬→飘蓬
由由然→飘飘然
俊逸→飘逸
单子→票据
抛清→撇清
望见→瞥见
拼集→拼凑
拼凑→拼集
冒死→拼命
搏命→拼死
缺少→贫乏
布衣交→贫贱交
贫乏→贫窭
贫困→贫苦
贫苦→贫困
穷人→贫民
贫苦→贫穷
贫苦→贫穷困难
家徒四壁→贫无立锥
血虚→贫血
频仍→频繁
比年→频年
反复→频频
频繁→频仍
品行→品德
风致→品格
仙风道骨→品格清高
仙风道骨→品格清高瘦骨如柴
等级→品级
丰度→品貌
喝茶→品茗
批评→品评
咀嚼→品味
品格→品质
约请→聘请
聘任→聘用
安全→平安
安然无恙→平安无事
同辈→平辈
青云直上→平步青云
通常→平常
平明→平旦
同等→平等
飞必冲天→平地一声雷
安定→平定
昭雪→平反
中分→平分
半斤八两→平分秋色
贱卖→平沽
安宁→平和平静
均衡→平衡
腻滑→平滑
说书→平话
清静→平静
平常→平居
平手→平局
均匀→平均
平旦→平明
平和→平宁
平淡→平平
不相上下→平起平坐
通常→平日
一生→平生
平常→平时
平局→平手
平昔→平素
平展→平坦
康庄大道→平坦大路
平素→平昔
停顿→平息
态度冷静→平心定气
持平立论→平心而谈
心平气和→平心静气
态度冷静→平心易气
夷易→平易
民→平易近
平易近人→平易近民
和颜悦色→平易近人
平正→平允
平坦→平展
公平→平正
评议→评断
说书→评话
批评→评论
讨论→评论辩论
把脉→评脉
公证人→评判人
裁判员→评判员
表明→评释
批评→评述
说长道短→评头论足
评断→评议
考语→评语
笔据→凭单
依附→凭借
根据→凭据
闭门造车→凭空杜撰
闭门造车→凭空捏造
凭据→凭证
圮绝→屏绝
聚精会神→屏气凝神
摈弃→屏弃
屏蔽→屏障
萍浮→萍泊
萍泊→萍浮
不期而遇→萍水相逢
足迹→萍踪
恶妻→泼妇
凶暴→泼辣
地痞→泼皮
反水不收→泼水难收
胆大如斗→泼天大胆
火上加油→泼油救火
必不得已→迫不得已
如饥似渴→迫不及待
毒害→迫害
逼近→迫近
逼良为娼→迫良为娼
逼近→迫临
勒令→迫令
急迫→迫切
迫不及待→迫在眉睫
停业→破产
破耗→破钞
排除→破除
背城借一→破釜沉舟
破费→破耗
粉碎→破坏
坠欢重拾→破镜重圆
扬声恶骂→破口大骂
褴褛→破烂
例外→破例
破碎→破裂
破裂→破碎
粉碎→破碎摧毁
破坏→破损
转悲为喜→破涕为笑
拂晓→破晓
气概气派→魄力
魂飞天外→魄散九霄
辨白→剖白
别析→剖辨
别析→剖别
判定→剖断
因噎废食→剖腹藏珠
解剖→剖解
表白→剖明
别析→剖判
剖判→剖释
跟班→仆从
跑堂→仆欧
到处奔走→仆仆风尘
仆役→仆人
西崽→仆役
奴仆→仆众
鞭挞→扑打
劈面→扑面
毁灭→扑灭
空中楼阁→扑朔迷离
鞭挞→扑挞
店保→铺保
放开→铺开
摆设→铺排
铺张扬厉→铺排张扬
摊平→铺平
浪费→铺张
铺排张扬→铺张扬厉
匍匐→蒲伏
膝行→蒲伏爬行
葵扇→蒲扇
五月→蒲月
空洞→朴陋
质朴→朴素
方正→朴直
朴实→朴质
正直→朴重
真诚→朴拙
普渡众生→普度众生
普度众生→普渡众生
遍及→普及
普度众生→普济群生
率土同庆→普天同庆
平凡→普通
大众化→普通化
出口成章→七步之才
东倒西歪→七颠八倒
乱七八糟→七零八落
忐忑不安→七上八下
手足无措→七手八脚
四通八达→七通八达
人多口杂→七言八语
人多口杂→七嘴八舌
泡茶→沏茶
老婆→妻子
凄切→凄惨
惨恻→凄怆
悲凄→凄切
难民营→栖流所
居住→栖身
亲串→戚属
呐呐→期艾
时期→期间
在即→期近
盼望→期望
限期→期限
诳骗→欺诳
陵暴→欺凌
吐刚茹柔→欺软怕硬
欺软怕硬→欺善怕恶
陵暴→欺侮
欺凌→欺压
敲诈→欺诈
黑暗→漆黑
齐全→齐备
门高莫对→齐大非偶
会合→齐集
划一→齐截
井井有条→齐齐整整
qq游戏→QQweb。Org 腾讯qq游戏
齐备→齐全
同心→齐心
划一→齐整
厥后→其后
当时→其时
实在→其实
别的→其它
别的→其余
此中→其中
奇妙→奇奥
妙计→奇策
稀罕→奇怪
异景→奇观
待价而沽→奇货可居
古迹→奇迹
美丽→奇丽
妙算→奇谋
怪杰→奇人
古怪→奇异乖张
比方→歧
支路→歧路
鄙视→歧视
邪路→歧途
祷告→祈祷
盼望→祈望
落魄→崎岖潦倒
马队→骑兵
进退维谷→骑虎难下
将遇良才→棋逢敌手
对弈→棋战
旗鼓相当→旗敌相当
半斤八两→旗鼓相当
马到成功→旗开得胜
马到成功→旗开马到
旗头→旗手
旗手→旗头
旌旗→旗帜
旌旗→旗子
摇尾乞怜→乞哀告怜
借款→乞贷
托钵人→乞丐
告假→乞假
求和→乞降
恳求→乞请
恳求→乞求
讨饭→乞食
讨救→乞援
求助→乞助
瞻仰→企盼
计划→企图
盼望→企望
难道→岂非
不论→岂论
起程→启程
启示→启迪
动身→启碇
开导→启发
动身→启航
发蒙→启蒙
开辟→启示
缘由→启事
草拟→起草
动身→起程
早先→起初
出发点→起点
刮风→起风
升沉→起伏
动怒→起火
发火点→起火点
发迹→起家
努力→起劲
升降→起落
最少→起码
拔锚→起锚
转机→起色
起家→起身
肇始→起始
发难→起事
首先→起首
死去活来→起死回生
告状→起诉
开始→起头
起初→起先
叛逆→起义
因由→起因
升引→起用
来源→起原
劈头→起源
气鼓鼓→气冲冲
气贯长虹→气冲牛斗
心胸→气度
愤怒→气忿
愤怒→气愤
风格→气概
魄力→气概气派
气→气鼓鼓
气壮山河→气贯长虹
天气→气候
气→气呼呼
断气→气绝
力气→气力
宇量→气量
心胸→气量气度
灰心→气馁
派头→气派
魄力→气势
气吞山河→气势磅礡
气吞山河→气势磅
风格→气势派头
八面威风→气势汹汹
威风凛凛→气势
气壮山河→气吞山河
意气相合→气味相合
意气相合→气味相投
岌岌可危→气息奄奄
面目一新→气象一新
怒冲冲→气汹汹
气势→气焰
盛气凌人→气焰万丈
高视睨步→气宇轩昂
高视阔步→气宇轩昂大摇大摆
气吞山河→气壮山河
气呼呼→气
吐故纳新→弃旧容新
搁置→弃捐
取舍→弃取
归天→弃世
弃文就武→弃文竞武
投笔从戎→弃文就武
弃捐→弃置
轮船→汽船
锅炉→汽锅
煤汽灯→汽油灯
泪流满面→泣不成声
泪流满面→泣如雨下
符合→契合
左券→契约
捏词→砌词
东西→器材
度量→器度
用具→器具
度量→器量
东西→器械
珍视→器重
恰如其分→恰到好处
恰恰→恰好
恰好→恰恰
碰巧→恰巧
恰到好处→恰如其分
正中下怀→恰如私愿
正是→恰是
好似→恰似
洽商→恰谈
洽商→洽谈
百般→千般
变化多端→千变万化
精益求精→千锤百炼
费尽心机→千方百计
流芳百世→千古流芳
流芳百世→千古留名
令媛→千金
岌岌可危→千钧一发
望远镜→千里镜
百了千当→千了百当
如出一辙→千篇一律
光怪陆离→千奇百怪
人算不如天算→千算万算，不值天一划
盘根错节→千头万绪
万万→千万
历尽艰辛→千辛万苦
千载一时→千载难逢
流芳百世→千载扬名
千载难逢→千载一时
确切不移→千真万确
将就→迁就
搬家→迁居
迁移→迁徙
拖延→迁延
迁徙→迁移
转动→迁移转变
扳连→牵缠
牵涉→牵扯
系念→牵挂捆扎
挂念→牵记
缠累→牵累
饮鸩止渴→牵萝补屋
扳连→牵涉
扳缠不清→牵丝扳藤
拖泥带水→牵丝攀藤
管束→牵制
谦虚→谦善
逊谢→谦谢
谦善→谦虚
签订→签定
署名→签名
具名→签字
前车之鉴→前车可鉴
前车可鉴→前车之鉴
出息→前程
上次→前次
滥觞→前导发轫
重作冯妇→前度刘郎
火线→前方
先锋→前锋
前仆后继→前赴后继
半途而废→前功尽弃
肩摩踵接→前后相接
前呼后拥→前呼后应
一呼百诺→前呼后拥
进步→前进
前线→前列
前赴后继→前仆后继
先驱→前驱
前往→前去
古人→前人
前线→前哨
宿世→前生
宿世→前世
夙世冤家→前世怨仇
忖前思后→前思后想
亘古未有→前所未有
条件→前提
未定之天→前途难料
鹏程万里→前途似锦
前去→前往
前夜→前夕
先哲→前贤
火线→前线
媒介→前言
前夕→前夜
来龙去脉→前因后果
先兆→前兆
货币→钱币
财帛→钱财
荷包→钱袋
金钱万能→钱可通神
赋税→钱粮
摇钱树→钱树子
货币→钱银
银号→钱庄
闭口→钳口
左右夹攻→钳形进攻
胁迫→钳制
隐藏→潜藏
埋没→潜匿
埋头→潜心
潜伏→潜在
黔首→黔黎
黔驴之技→黔驴技穷
黔驴技穷→黔驴之技
黔黎→黔首
浮浅→浅薄
肤见→浅见
浅显→浅近
淡色→浅色
浅近→浅显
含笑→浅笑
驱逐→遣散
非难→谴责
不佳→欠安
不好→欠好
不通→欠亨
借据→欠据
短缺→欠缺
呵欠→欠伸
不当→欠妥
负债→欠债
荒年→歉岁
抱歉→歉仄
子弹→枪弹
音调→腔调
逼迫→强逼
蛮横无理→强词夺理
匪贼→强盗
劲敌→强敌
夸大→强调
刁悍→强悍
霸道→强横
矫健→强健
猛烈→强烈
热烈→强烈热闹
劫掠→强抢
刚强→强项
倔强→强硬
逼迫→强制
劫掠→抢夺
掳掠→抢劫
救济→抢救
劫掠→抢掠
争先→抢先
寂静→悄悄
偷偷的→悄悄的
寂静→悄然
寂静→悄然默默
拍门→敲门
诓骗→敲诈
巧取豪夺→敲诈勒索
软硬兼取→敲榨勒索
燕徙→乔迁
出谷迁乔→乔迁之喜
改扮→乔妆
外侨→侨民
鬼斧神工→巧夺天工
妙策→巧计
巧言→巧舌
巧舌→巧言
巧言→巧语
奸巧→巧诈
绝壁→峭壁
秘诀→窍门
魁首→翘楚
切齿痛恨→切齿腐心
痛心疾首→切齿痛恨
探讨→切磋
互相研究→切磋琢磨
确切→切当
切身痛苦→切肤之痛
牢记→切记
直谏→切谏
贴近→切近
逼近→切近亲近
隐语→切口
把脉→切脉
万万→切切
喁喁私语→切切私语
精确→切确
亲身→切身
切肤之痛→切身痛苦
确切→切实
的确→切实其实
贴题→切题
临时→且则
临时→且自
懦夫→怯夫
胆小→怯懦
胆怯→怯怯乔乔
胆小→怯弱
胆怯→怯生生
扒手→窃匪
偷窥→窃看
交头接耳→窃窃私议
交头接耳→窃窃私语
盗取→窃取
偷窥→窃视
暗笑→窃笑
扒手→窃贼
酷爱→亲爱
戚属→亲串
密切→亲近
和好→亲睦
密切→亲昵
亲友→亲朋
密切→亲切
情同骨肉→亲如手足
敦睦→亲善
婚事→亲事
知己→亲信
舟中敌国→亲信背叛
亲朋→亲友
支属→亲属
亲身→亲自
劫夺→侵夺
陵犯→侵害
陵犯→侵陵
劫夺→侵掠
扰乱→侵扰
陵犯→侵扰进犯
腐蚀→侵蚀
陵犯→侵吞
陵犯→侵占
景仰→钦慕
佩服→钦佩
两姓之欢→秦晋之好
明镜高悬→秦镜高悬
比翼双飞→琴瑟调和
比翼双飞→琴瑟和谐
比翼双飞→琴瑟同谱
比翼双飞→琴瑟同谐
比翼双飞→琴瑟之好
勤劳→勤奋
发愤→勤苦
勤奋→勤劳
勤奋→勤勉
艰苦朴素→勤勤俭俭
好学→勤学
孳孳不息→勤学不辍
停战→寝兵
貌寝→寝陋
食不甘味→寝食不安
睡房→寝室
就寝→寝息
睡衣→寝衣
沁人心脾→沁人肺腑
后来居上→青出于蓝
芳华→青春
青翠→青葱
青葱→青翠
是非黑白→青红皁白
是非黑白→青红皂白
两小无猜→青梅竹马
使臣→青鸟使
堪舆术→青鸟术
彼苍→青天
光天化日→青天白日
田鸡→青蛙
雄心壮志→青云之志
扶摇直上→青云直上
简便→轻便
浮滑→轻薄
得心应手→轻车熟路
侮慢→轻渎
十拿九稳→轻而易举
微风→轻风
浮滑→轻浮
忽视→轻忽
下贱→轻贱
胆大妄为→轻举妄动
浮滑→轻狂
率尔操觚→轻率下笔
藐视→轻蔑
口不择言→轻诺寡言
柔柔→轻柔
藐视→轻视
蹑手蹑脚→轻手轻脚
轻细→轻微
轻微→轻细
方便→轻易
本末倒置→轻重倒置
洗耳恭听→倾耳细听
颠覆→倾覆
倾盖论交→倾盖定交
倾盖之交→倾盖论交
倾盖论交→倾盖之交
败尽家业→倾家荡产
悉索敝赋→倾尽国库
倾心→倾慕
滂湃→倾盆
滂沱大雨→倾盆大雨
倒塌→倾圮
倾吐→倾诉
谛听→倾听
倾诉→倾吐
倾慕→倾心
坍毁→倾圯
排挤→倾轧
明净→清白
归还→清偿
清亮→清澈
清早→清晨
明了→清楚明了
明白→清楚明明
响亮→清脆
平淡→清淡
月白风清→清风明月
狷介→清高
金科玉律→清规戒律
剿灭→清剿
寂静→清静
傍友→清客
明朗→清朗
清凉→清冷
廉洁→清廉
清冷→清凉
清澈→清亮
明朗→清明
明朗→清明明亮
贫苦→清贫
太平时世→清平世界
排除→清扫
净水→清水
整理→清算
算帐→清算计帐
洗濯→清洗
安定→清闲
秀气→清秀
朝晨→清早
谍报→情报
身不由己→情不自禁
急中生智→情急智生
景象→情景
环境→情况
人情→情面
恋人→情人
情同手足→情同骨肉
情同骨肉→情同手足
同舟共济→情投意合
感情→情绪
交谊→情谊
情谊→情意
来由→情由
情之所锺→情有独锺
无可非议→情有可原
情有独锺→情之所锺
景况→情状
天晴→晴和
明朗→晴朗
明朗→晴明
好天→晴天
砥柱中流→擎天一柱
霎时→顷刻
致意→请安
告假→请假
讨教→请教
宴客→请客
央求条件→请求恳求
叨教→请示
请柬→请帖
拜托→请托
叨教→请问
讨救→请援
示威→请愿
光荣→庆幸
寒冬→穷冬
贫乏→穷乏
穷苦人→穷鬼
穷人→穷汉
贫民→穷户
追究→穷究
贫苦→穷苦
贫乏→穷困
潦倒穷困→穷困潦倒
仁至义尽→穷力尽心
日积月累→穷年累月
贫民→穷人
穷乡僻壤→穷山恶水
酒绿灯红→穷奢极欲
命运坎坷→穷途潦倒
断港绝潢→穷途末路
穷山垩水→穷乡僻壤
穷苦相→穷相
僻巷→穷巷
暴戾恣睢→穷凶极恶
穷源溯流→穷源竟委
穷源竟委→穷源溯流
美酒→琼浆
金风抽丰→秋风
天高气爽→秋高气爽
秋天景色→秋景
转蓬→秋蓬
蘼芜路断→秋扇见捐
秋日→秋天
犯人→囚犯
犯人→囚徒
监禁→囚系
供不应求→求过于供
讨教→求教
讨情→求情
责备→求全
指责→求全谴责
讨饶→求饶
拜鬼求神→求神拜佛
拜鬼求神→求神拜鬼
修业→求学
梦寐以求→求之不得
告急→求助
危急→求助紧急
游泳→泅水
戋戋→区区
地区→区域
曲堤→曲岸
曲岸→曲堤
唱本→曲稿
乐谱→曲谱
弯弯曲曲→曲曲折折
偏言→曲说
羊肠小道→曲折小路
是曲→曲直
黑白→曲直短长
美满收场→曲终奏雅
驱使→驱策
奔走→驱驰
驱策→驱使
枉驾→屈驾
屈服→屈就
委曲→屈身
投降→屈膝投降
巴结→趋承
夤缘→趋奉
趋之若鹜→趋附者众
趋向→趋势
趋势→趋向
趋附者众→趋之若鹜
立定脚跟→取得根据
牟利→取利
取暖和→取暖
弃取→取舍
打水→取水
废除→取销
讽刺→取笑
媚谄→取悦
纳宠→娶妾
结婚→娶亲
蛀牙→龋齿
行止→去处
披沙拣金→去粗取精
辞官→去官
客岁→去年
杳如黄鹤→去如黄鹤
毕命→去逝
披沙拣金→去伪存真
去处→去向
离职→去职
妙语→趣话
意见意义→趣味
妙闻→趣闻
第三者→圈外人
天下→全国
百口→全家
三军→全军
全军尽没→全军覆没
无一生还→全军尽没
端赖→全靠
尽力→全力
万能→全能
整年→全年
通盘→全盘
环球→全球
整日→全日
满身→全身
满是→全是
全部→全数
一丘之貉→全无分别
一无所知→全无所闻
经心→全心
病愈→全愈
职权→权柄
机谋→权略
权术→权谋
权威→权势巨子
霸术→权术
官僚→权要
权柄→权益
货币→泉币
墓穴→泉台
源头→泉源
病愈→痊可
病愈→痊愈
长短不一→犬牙交错
犬牙交错→犬牙相制
感导→劝化
规劝→劝戒
奉劝→劝说
抚慰→劝慰
拦阻→劝止
罅漏→缺漏
倒是→却是
斑点→雀斑
反宾为主→雀巢鸠占
高兴→雀跃
建立→确立
千真万确→确切不移
喧宾夺主→鹊巢鸠占
群魔乱舞→群丑跳梁
聚集→群集
群丑跳梁→群魔乱舞
议论→群情
但是→然则
抱病→染病
问鼎→染指
转让→让渡
富足→饶富
宽恕→饶恕
引火烧身→惹火烧身
肇事→惹祸
触怒→惹恼
引人→惹人
高潮→热潮
激情亲切→热忱
人性→人道
地利人和→人地相宜
生齿→人丁
七嘴八舌→人多口杂
僧多粥少→人浮于事
品德→人格
丰衣足食→人给家足
打胎→人工流产
钟灵毓秀→人杰地灵
生齿→人口
老树枯柴→人老珠黄
黄包车→人力车
行同狗彘→人面兽心
性命→人命
气息奄奄→人命危浅
品德→人品
情面→人情
世态炎凉→人情冷暖
大家→人人
人间→人世
千算万算，不值天一划→人算不如天算
民气→人心
胆战心惊→人心惶惶
火食→人烟
职员→人员
因缘→人缘
铁中铮铮→人中表表
不由得→忍不住
吃苦俭朴→忍苦
含垢忍辱→忍辱含垢
含垢忍辱→忍尤含诟
认贼为子→认敌为友
承认→认可
了解→认识
明白→认识打听
认敌为友→认贼为子
听凭→任凭
办事→任事
听天由命→任天由命
使命→任务
胡作非为→任性妄为
恣意→任意
孕妇→妊妇
怀胎→妊娠
抛弃→扔掉
投掷→扔掷
还是→仍是
一样平常→日常
平时→日常平凡
日志→日记
白天→日间
每况愈下→日就衰败
早晚→日夕
星期日→日曜日
昼夜→日夜
夙夜匪懈→日夜勉
日记→日志
盛极必衰→日中则昃
蛮夷→戎狄
军装→戎服
军事机密→戎机
兵马→戎马
军队→戎行
军装→戎衣
繁华→荣华
兴废→荣枯
光彩→荣耀
边幅→容貌
立足→容身
包庇→容隐
溶化→熔解
领悟→融会
杂税→冗赋
柔嫩→柔滑
柔软→柔嫩
薄弱→柔弱虚弱
格斗→肉搏
赘瘤→肉瘤
心痛→肉痛
众口一词→如出一口
云云→如此
细姨→如夫人
仍旧→如故
要是→如果
怎样→如何
伊于胡底→如何了局
如之奈何→如何是好
为虎傅翼→如虎添翼
风起云涌→如火如荼
大喜过望→如获至宝
现在→如今
准期→如期
方兴未艾→如日中天
如失父母→如丧考妣
如丧考妣→如失父母
俯拾地芥→如拾草芥
如此→如斯
好像→如同
这样→如许
趋附者众→如蚁附膻
快意→如意
跬步不离→如影随形
若有→如有
践约→如约
如何是好→如之奈何
吃素→茹素
孔教→儒教
渴念→孺慕
童子→孺子
黄口孺子→乳臭未干
干娘→乳母
唾骂→辱骂
屈辱→辱没
戏弄→辱弄
中计→入彀
入境问禁→入国问俗
入国问俗→入境问禁
犯境→入寇
着迷→入神
开始→入手下手
中计→入网
定罪→入罪
囊空如洗→阮囊羞涩
绳梯→软梯
得寸进尺→软土深掘
敲榨勒索→软硬兼取
刻意→锐意
修饰→润色
粉饰→润饰藻饰
滋润→润泽
滋润→润泽津润
多少→若干
几多→若干好多
如何→若何
奈何→若何怎样
雾里看花→若明若暗
如果→若是
如有→若有
缺点→弱点
流传→撒播
流传→撒布
说谎→撒谎
溘然长逝→撒手尘寰
挥泪→洒泪
因祸得福→塞翁失马
敷衍→塞责
跑马→赛马
竞走→赛跑
竞渡→赛舟
鼎足之势→三分鼎足
半夜→三更
半夜→三鼓
三回九转→三回九曲
三回九曲→三回九转
全军→三军
再三告诫→三令五申
宾客盈庭→三千珠履
成群结队→三五成群
鼎足之势→三足鼎立
拆伙→散伙
故里→桑梓
闾里→桑梓同乡
失怙→丧父
六神无主→丧魂失魄
漏网之鱼→丧家之犬
失恃→丧母
归天→丧生
丧尽天良→丧心病狂
扰乱→骚动扰攘侵犯
墨客→骚人
省墓→扫墓
全部→扫数
虚有其表→色厉内荏
心醉情移→色授魂与
光彩→色泽
丛林→森林
人浮于事→僧多粥少
和尚→僧人
法衣→僧衣
竭泽而渔→杀鸡取卵
扑灭→杀绝
达成→杀青
滥杀无辜→杀人如麻
杀鸡骇猴→杀一儆百
沙滩→沙岸
疆场→沙场
梵衲→沙门
戈壁→沙漠
沙岸→沙滩
瞬间→刹时
笨头笨脑→傻里傻气
天公疼核→傻人有傻福
费尽心血→煞费苦心
天台→晒台
山水→山川
极峰→山顶颠峰
岩穴→山洞
猴子→山公
拙荆→山荆
老虎→山君
野鹤闲云→山林隐士
庙门→山门
天南地北→山南海北
拙荆→山妻
隐士→山人
山川→山水
山峰→山岳
盗窟→山寨
编削→删改
删节→删省
煽惑→煽动
煽动→煽惑
霹雳战→闪电战
闪灼→闪动
让开→闪开
显现→闪现
闪灼→闪耀
闪烁→闪灼
黑白不分→善恶不分
吉人天相→善者神佑
自作打算→善自为谋
誊录→缮写
补葺→缮治
专权→擅权
私自→擅自
米饭钱→赡养费
悲悼→伤悼
感冒→伤风
有伤风化→伤风败俗
惊弓之鸟→伤弓之鸟
遍体鳞伤→伤痕累累
忧国忧民→伤时感事
血肉横飞→伤亡枕藉
牌号→商标
阛阓→商场
市肆→商店
店铺→商号
探讨→商量
商店→商铺
谈判→商洽
商讨→商榷
贩子→商人
贸易→商业
商量→商议
商量→商酌
惩罚→赏罚
悬赏→赏格
赏脸→赏光
赏光→赏脸
欣赏→赏识
抚玩→赏玩
弄月→赏月
登陆→上岸
彼苍→上苍
前次→上次
被骗→上当
天主→上帝
吊颈→上吊
中计→上钩
上网→上彀
大将→上将
被骗→上圈套
落草为寇→上山作贼
上彀→上网
言传身教→上行下效
另有→尚有
舵手→梢公
煮饭→烧饭
废弃→烧毁
时光→韶光
年华→韶华
少年老成→少年事重
暂休→少憩
片刻→少顷
极少→少少
幼年→少小
片刻→少焉
罕用→少用
继述→绍述
尖兵→哨兵
叫子→哨子
费尽唇舌→舌敝唇焦
能言善辩→舌粲莲花
译员→舌人
长枪→蛇矛
本末倒置→舍本逐末
寒舍→舍间
视死如归→舍身殉难
寒舍→舍下
设置装备摆设→设备
捏词→设词
捏词→设辞
想法→设法
想法→设法主意
计划→设计
建立→设立建设
办法→设施
设宴→设席
设席→设宴
配置→设置装备摆设
交际→社交
弓手→射手
命中→射中
渡水→涉水
赦宥→赦免
赦免→赦宥
免罪→赦罪
震怖→慑伏
养生→摄生
拍照→摄影
开麦拉→摄影机
报告→申报
辩论→申辩
告诫→申饬
说明→申明
申说→申诉
致谢→申谢
叩谢→伸谢
身段→身材
身材→身段
因素→身分
身死→身故
死后→身后
出身→身世
技艺→身手
身故→身死
体态→身形
缙绅→绅耆
名流→绅士
渺不可测→深奥无极
大智若愚→深藏若虚
切齿腐心→深恶痛绝
闪烁其词→深加隐讳
厚交→深交
穷究→深究
深入→深切
酷爱→深嗜
寻思→深思
深图远虑→深思熟虑
深沉→深邃深挚
深思熟虑→深图远虑
更阑→深宵
笃信→深信
深厚→深挚
极重繁重→深重
神色→神采
神采飞扬→神采奕奕
向往→神驰
出没无常→神出鬼没
天造地设→神工鬼斧
怪诞→神怪
精神病→神经病
秘密→神秘
神情→神气
模样形状→神情
妙算→神算
模样形状→神态
法术→神通
极乐世界→神仙世界
神态→神志
丰采→神姿
检察→审查
打量→审察
核定→审定
考核→审核
过堂→审问
核阅→审阅
乃至→甚至
排泄→渗出
渗透→渗入
渗透→渗入渗出
紧密→慎密
起伏→升沉
起落→升降
泰平承平→升平平安
造诣高深→升堂入室
仙游→升天
起用→升引
抱病→生病
命途多舛→生不逢辰
天生→生成
人口→生齿
不学而能→生而知之
蛮人→生番
水果→生果
生存→生活
米饭钱→生活费
生涯→生活生计
生气勃勃→生机勃勃
生存→生计
活埋→生坑
新力量→生力军
恐怕→生怕
平生→生平
负气→生气
龙马精神→生气勃勃
生机→生气希望
宠辱祸福→生杀与夺
生息不断→生生不已
世世代代→生生世世
肇事→生事
存亡→生死
紧要关头→生死关头
刎颈交→生死之交
不求甚解→生吞活剥
生生不已→生息不断
见效→生效
素性→生性
买卖→生意
交易→生意业务
生养→生育
出奇制胜→声东击西
声息→声气
疾言厉色→声色俱厉
阵容→声势
气吞山河→声势浩大
浩浩荡荡→声势赫赫
阵容→声威
声气→声息
名震一时→声誉鹊起
增援→声援
张扬→声张
畜生→牲口
压服→胜过
名胜→胜景
左券在握→胜券在握
准绳→绳尺
软梯→绳梯
绳索→绳子
省检→省察
省垣→省城
免得→省得
免却→省掉
省城→省会
省察→省检
扫墓→省墓
免却→省却
憬悟→省悟
省城→省垣
贤人→圣人
诏书→圣旨
哄传→盛传
大德→盛德
日中则昃→盛极必衰
大怒→盛怒
不可一世→盛气凌人
盛意→盛情
严阵以待→盛食厉兵
妖装→盛饰
酷暑→盛暑
隆替→盛衰
盛情→盛意
艳服→盛装
尸骸→尸骨
墓木已拱→尸骨早寒
尸骨→尸骸
登仙→尸解
尸体→尸身
尸体→尸首
遗体→尸体
越权代理→尸祝代庖
失察→失策
失策→失察
变态→失常
合浦珠还→失而复得
丧父→失怙
丢魂失魄→失魂落魄
冒失鬼→失魂鱼
火警→失火
失时→失机
失察→失计
讲错→失口
败北→失利
迷途→失路
掉→失落
失信→失期
失色→失容
忘形→失色
失色→失神
不慎→失慎
误事出事→失事
丧母→失恃
失察→失算
忘形→失态
沦陷→失陷
讲错→失言
赋闲→失业
失礼→失仪
失信→失约
失窃→失贼
当面错过→失之交臂
失落→失踪
出错→失足
落空→失
先生→师长教师
效法→师法
墨客→诗人
行礼→施礼
救济→施舍
赠医→施医
表现→施展阐发
檀越→施主
赈济→施助
泰山压卵→狮子搏兔
湿漉漉→湿淋淋
罪大恶极→十恶不赦
非常→十分
好不容易→十分困难
安若泰山→十拿九稳
完美无缺→十全十美
旬日→十日
满目荒凉→十室九空
皮娇肉嫩→十指尖尖
统统→十足
实物→什物
碑本→石本
不知去向→石沉大海
邓通之财→石崇之富
石匠→石工
土鸡瓦犬→石鼓沙田
石工→石匠
白腊→石蜡
平地一声雷→石破天惊
煤油→石油
好友→石友
时不再来→时不我待
时不我待→时不再来
时候→时辰
期间→时代
韶光→时光
马齿徒增→时光虚掷
明日黄花→时过境迁
时间→时候
机遇→时机
时值→时价
时势→时局
时候→时刻
念念不忘→时刻不忘
季候→时令
每时每刻→时时刻刻
时势→时事
局势→时势
格于环境→时势所迫
漂亮→时兴
时价→时值
看破→识破
见机→识趣
知趣→识相
真话→实话
现实→实际
气力→实力
真相→实情
及时→实时
练习→实习
实验→实行
实行→实验
着实→实在
十足→实足
摒挡→拾掇
拾人牙慧→拾人涕唾
赔本→蚀本
寝食不安→食不甘味
门客→食客
食品→食物
言而不信→食言而肥
米珠薪贵→食玉炊桂
吃素→食斋
史乘→史册
史书→史乘
史乘→史籍
亘古未有→史无前例
一口咬定→矢口不移
矢语发誓→矢誓
百发百中→矢无虚发
矢誓→矢言
赌咒→矢语
矢誓→矢语发誓
天长地久→矢志不移
青鸟使→使臣
驱使→使令
任务→使命
婢女→使女
负气→使气
利用→使用
青鸟使→使者
初创→始创
委曲→始末
父执→世伯
人心不古→世道沦亡
油滑→世故
凡间→世间
天下→世界
天下一家→世界大同
众人→世人
生生世世→世世代代
人情冷暖→世态炎凉
事过境迁→世易时移
官吏→仕宦
做官→仕进
宦途→仕途
市肆→市廛
市面→市道
市面→市道市情
讨好→市欢
墟市→市集
时价→市价
屠狗之辈→市井之徒
奸商→市侩
市面→市情
商店→市肆
树模→示范
请愿→示威
表示→示意
斧正→示正
告知→示知
衰落→式微
模样形状→式样
款式→式子
变乱→事变
变乱→事故
过后→事后
古迹→事迹
变乱→事件
道理→事理
事变→事情
究竟→事实
局势→事势
局势→事势时事
局势→事态
事件→事务
事变→事项
奇迹→事业
事件→事宜
本家儿→事主
随从→侍从
奉养→侍奉
跑堂→侍役
跑堂→侍者
当者披靡→势不可当
进退维谷→势成骑虎
半斤八两→势均力敌
目力→视力
滥杀无辜→视如草芥
置若罔闻→视若无睹
成仁取义→视死如归
等量齐观→视同一律
百依百顺→视为心腹
碰运气→试试看
摸索→试探
遁词→饰词
托言→饰辞
金饰→饰物
扮演→饰演
住宅→室第
人去楼空→室迩人遐
住宅→室庐
家徒壁立→室如悬磬
狐假虎威→恃势凌人
黑白→是非
青红皁白→是非黑白
青红皁白→是非曲直
曲直→是曲
这天→是日
因此→是以
刚才→适才
得当→适当
拔苗助长→适得其反
得当→适合
恰到好处→适可而止
写意→适意
顺应→适应
刚巧→适值
开释→释放
佛教→释教
不共戴天→誓不两立
收获→收成
劳绩→收获
网络→收集
收条→收据
征求→收罗
难民营→收容所
摒挡→收拾
整理→收拾整顿
专心致志→收视反听
屏气凝神→收视返听
罢手→收手
回收→收受接管
紧缩→收缩
收据→收条
扫尾→收尾
见效→收效
停业→收歇
出入→收支
抄本→手本
腕表→手表
名片→手刺
着手成春→手到回春
本领→手段
手简→手翰
目送手挥→手挥目送
本领→手腕
赤手空拳→手无寸铁
部下→手下
技术→手艺
指模→手印
书信→手札
拐杖→手杖
伯仲→手足
手足重茧→手足胼胝
同气连枝→手足同心
惊惶失措→手足无措
手足胼胝→手足重茧
戍卒→守兵
吝啬鬼→守财奴
遵法→守法
守拙→守分
等待→守候
保卫→守护
持志→守节
定时→守时
同舟共济→守望相助
取信→守信
深藏若虚→守愚藏拙
守卫→守御
持志→守志
守分→守拙
提倡→首倡
初次→首次
都城→首都
正犯→首犯
首领→首级
头领→首级头目
领袖→首脑
压倒一切→首屈一指
金饰→首饰
起首→首先
宰衡→首相
主要→首要
被宠若惊→受宠若惊
沾恩→受惠
吃惊→受惊
奉命→受命
倒持泰阿→受人以柄
立室→受室
伏法→受刑
被骗→受愚
抱屈→受冤
怀胎→受孕
讲课→授课
倒持泰阿→授人以柄
娶妻→授室
付与→授予
给与→授与
品格清高→瘦骨如柴
消瘦→瘦削
切口→瘦语
书籍→书本
言不尽意→书不宣意
书柜→书厨
书柜→书橱
书函→书牍
书柬→书函
字画→书画
册本→书籍
布告→书记
书函→书简
书箱→书箧
誊写→书写
学堂→书院
书函→书札
纾难→抒难
抒怀→抒情
要津→枢路
关键→枢纽
决死→殊死
打扮→梳妆
粉饰→梳妆化妆
重义轻财→疏财仗义
讲明→疏解
疏通→疏浚
疏导→疏浚沟通
荒凉→疏落
抛荒→疏弃
疏导→疏通沟通
开怀→舒怀
安宁→舒适
痛快酣畅→舒坦
蔓延→舒展
运送→输送
熟习→熟谙
丰年→熟年
置若罔闻→熟视无睹
老手→熟手在行
内行→熟行
代理→署理
榜书→署书
小肚鸡肠→鼠肚鸡肠
方士→术士
法术→术数
防守→戍守
卫护→戍卫
守兵→戍卒
束缚→束厄局促
引颈就戮→束身待罪
计无所出→束手待毙
计无所出→束手就擒
一筹莫展→束手无策
置之不理→束之高阁
整装→束装
陈说→述说
名高引谤→树大招风
立德→树德
结怨→树敌
树模→树范
树范→树模
建立→竖立
百姓→庶民
杂务→庶务
不可胜数→数不胜数
不足为奇→数见不鲜
数目→数量
恒河沙数→数以万计
洗擦→刷洗
革新→刷新
朽迈→衰老
颓龄→衰年
薄弱→衰弱懦弱
颓败→衰颓
阑珊→衰退
灭亡→衰亡
陵夷→衰微
跌倒→摔倒
抛弃→甩掉
放手→甩手
两边→双方
左右开弓→双管齐下
爽利→爽脆
爽快→爽利
爽利→爽气爽直
干脆→爽性
坦直→爽直
那个→谁人
海军→水兵
池塘→水池
迎刃而解→水到渠成
水点→水滴
水脚→水费
沟渠→水沟
水灾→水患
水深火热→水火倒悬
舶来品→水货
水费→水脚
河清海晏→水静无波
真相大白→水落石出
沟渠→水渠
如胶似漆→水乳交融
浮家泛宅→水上人家
水火倒悬→水深火热
海军→水师
不服水土→水土不服
水患→水灾
寝室→睡房
就寝→睡眠
寝衣→睡衣
趁便→顺便
安产→顺产
按序→顺次
遵从→顺从
顺服→顺从制服
驯服→顺服
瓜熟蒂落→顺理成章
顺遂→顺利
顺道→顺路
天真烂漫→顺其自然
随手→顺手
因利乘便→顺水推舟
顺利→顺遂
适应→顺应
刹时→瞬间
顷刻→瞬息
变化多端→瞬息万变
说三道四→说长道短
拉拢→说合
语言→说话
撒谎→说谎
解说→说明注解
提及→说起
讨情→说情
说长道短→说三道四
谈笑→说笑
说一是一→说一不二
一言为定→说一是一
庞大无比→硕大无朋
法律→司法
屡见不鲜→司空见惯
管库→司库
经理→司理
管帐→司帐
第宅→私邸
便函→私函
私人→私家
偏见→私见
私情→私交
学堂→私塾
秘密交易→私相授受
屈打成招→私刑逼供
擅自→私行
私衷→私意
耳语→私语
走私→私运
私意→私衷
擅自→私自
思绪→思路
思考→思虑
缅怀→思念
思想→思惟
头脑→思维
头脑→思想
思路→思绪
怀疑→思疑
须臾→斯须
沙哑→嘶哑
扯破→撕裂
去世→死
枯燥→死板
诀别→死别
死有余辜→死不足惜
死去活来→死而复活
身后→死后
东山再起→死灰复然
大张旗鼓→死灰复燃
生死→死活
尸谏→死谏
极力→死力
毕命→死灭
暮气→死气
少气无力→死气沉沉
死而复活→死去活来
啮臂之交→死生之交
啮臂之交→死生之契
苦守→死守
殒命→死亡
断念→死心
执迷不悟→死心塌地
极刑→死刑
罪不容诛→死有余辜
决战苦战→死战
家徒壁立→四壁萧条
到处→四处
跋山涉水→四处奔波
分崩离析→四分五裂
到处为家→四海为家
四序→四季
骈体文→四六文
四季→四时
七通八达→四通八达
手脚→四肢举动
当铺→寺库
太监→寺人
庙宇→寺院
奉养→伺候
侦察→伺探
俟机→伺隙
彷佛→似乎
胶漆相投→似漆如胶
貌同实异→似是而非
豢养→饲养
残虐→肆虐
任意→肆意
松懈→松弛
疏松→松散
放手→松手
松弛→松懈
煽动→怂恿
挺立→耸立
屹然→耸然
骇人听闻→耸人听闻
屹立→耸峙
官司→讼事
投递→送达
除旧布新→送旧迎新
送死→送命
执绋→送丧
奉上→送上
送命→送死
送旧迎新→送往迎来
执绋→送葬
口碑载道→颂声遍野
歌颂→颂扬
缉捕→搜捕
查抄→搜查
搜索→搜刮
检查→搜检
抄掠→搜劫
收罗→搜聚
包罗→搜罗
搜刮→搜索
征采→搜寻
复苏→苏醒
陋儒→俗儒
鄙谚→俗语
抱怨→诉苦
根除→肃除
庄严→肃静
端庄→肃静严厉
寂然→肃然
庄重→肃肃
故旧→素交
向来→素来
素不相识→素昧生平
本心→素心
生性→素性
素志→素愿
素愿→素志
本质→素质
速率→速度
旧恨→宿恨
重病→宿疾
老将→宿将
前世→宿世
旧恨→宿怨
旧债→宿债
旧帐→宿帐
计划精巧→算无遗策
看成→算作
举动当作→算做
固然→虽然
漫笔→随笔
任意→随便
同流合污→随波逐流
到处→随处
跟从→随从跟随
因地制宜→随机应变
吠影吠声→随声附和
陪侍→随侍
顺手→随手
顺俗→随俗
马马虎虎→随随便便
为所欲为→随心所欲
任意→随意率性
轻易→随意马虎
比年不登→岁比不登
年末→岁暮
岁收→岁入
年头→岁首
年初→岁首年月
年龄→岁数
年底→岁尾
光阴→岁月
年末→岁终
称心快意→遂心如愿
破裂→碎裂
庶务→碎务
消耗→损耗
假公济私→损人利己
毁伤→损伤
挑拨→唆使
巡察→梭巡
收缩→缩短
漠不关心→缩手旁观
诸多忌惮→缩手缩脚
长处→所长
遇人不淑→所嫁非人
势如破竹→所向披靡
势如破竹→所向无敌
明目张胆→所行无忌
以是→所以
全部→所有
地点→所在
不一而足→所在多有
探索→索求
枯燥乏味→索然无味
讨债→索债
噜苏→琐碎
鳞爪→琐闻
杂务→琐务
零碎→琐细
鸡零狗碎→琐屑零星
部属→属下
留意→属意
另日→他日
参考之资→他山之石
异乡→他乡
二心→他心
垮台→塌台
征伐→挞伐
脚踏实地→踏踏实实
大名→台甫
举高→抬高
提拔→抬举
仰面→抬头
反宾为主→太阿倒持
沧海微尘→太仓一粟
太始→太初
旷古→太古
太甚→太过
宦官→太监
平静→太平
清平世界→太平时世
太过→太甚
太初→太始
叹息→太息
御医→太医
大半→泰半
太古→泰初
升平→泰平承平
狮子搏兔→泰山压卵
泰山其颓→泰山殒落
倒塌→坍毁
贪嘴→贪馋
饕餮→贪吃
贪官污吏→贪官蠹役
贪杯→贪酒
贪心→贪婪
迷恋→贪恋
企图→贪图
得陇望蜀→贪猥无厌
饮马投钱→贪污舞弊
贪婪→贪心
得陇望蜀→贪心不足
放开→摊开
铺平→摊平
口才→谈锋
发言→谈话
茶话会→谈话会
评论辩论→谈论
会商→谈判
言论→谈吐
言笑→谈笑
妙语横生→谈笑风生
交心→谈心
档册→檀案
案卷→檀卷
开阔→坦荡
推心置腹→坦怀相待
装甲车→坦克车
直率→坦直
掩盖→袒护
赤身露体→袒裼裸裎
闲云野鹤→袒自若
怨嗟→叹恨
太息→叹气
悲叹→叹伤
叹惋→叹惜
拜望→探访
探究→探讨
看望→探望
拜望→探望打听
打听→探问
探问→探询
打听→探询探望
敷衍→唐塞
冒昧→唐突
明目张胆→堂堂皇皇
大公至正→堂堂正正
从兄弟→堂兄弟
珐琅→搪瓷
冒犯→搪突
倘若→倘使
滴下→淌下
取出→掏出
滚滚→滔滔
口若悬河→滔滔不绝
源源而来→滔滔而至
躲避→逃避
跳出火炕→逃出生天
兔脱→逃窜
避祸→逃难
逃走→逃脱
避难→逃亡
越狱→逃狱
抱头鼠窜→逃之夭夭
逃脱→逃走
鸟语花香→桃红柳绿
感导→陶染
熏陶→陶冶
邓通之财→陶猗之富
迷恋→陶醉
调皮→淘气
镌汰→淘汰
诛讨→讨伐
托钵→讨饭
请援→讨救
说情→讨情
求饶→讨饶
腻烦→讨厌
乞援→讨援
讨债→讨帐
分外→特别
非常→特别很是
出力异常→特别卖力
彪炳→特出
专程→特地
殊效→特效
特地→特意
腾跃→腾踊
腾踊→腾跃
腾云驾雾→腾云跨风
誊写→誊录
誊录→誊写
哭笑不得→啼笑皆非
提升→提拔
防范→提防
提要→提纲
一针见血→提纲契领
一语道破→提纲挈领
提拔→提升
胆战心惊→提心吊胆
发起→提议
文体→体裁
方式→体例
体贴→体谅
面子→体面
方式→体式格局
身形→体态
体会→体味
遍体鳞伤→体无完肤
体制→体系体例
表现→体现
运动场→体育场
理发→剃头
涕泣→涕零
替换→替代
更换→替换
替人→替身
长命百岁→天保九如
天翻地覆→天崩地裂翻天覆地
天分→天禀
大相径庭→天差地别
海誓山盟→天长地久
鬼哭神号→天愁地惨
法网恢恢→天道好还
天壤之别→天地之别
天禀→天分
天南地北→天各一方
入夜→天黑
昏天黑地→天昏地暗
庭院→天井
网罗密布→天罗地网
定命→天命
天南海北→天南地北
天南地北→天南海北
天算→天年
自然→天然
天气→天色
天年→天算
露台→天台
天国→天堂
法网恢恢→天网恢恢
率土归心→天下归心
天下升平→天下太平
世界大同→天下一家
天助→天佑
灵活→天真
顺其自然→天真烂漫
浑金璞玉→天真未凿
上帝→天主
资质→天资
枝节横生→添枝加叶
添油加醋→添枝接叶
田契→田单
佃户→田户
野猎→田猎
旷野→田野
故乡→田园
地主→田主
澹泊→恬淡
淡泊→恬澹
安静→恬静
舒服→恬逸
长处→甜头
蜜语→甜言
添补→填充
推涛作浪→挑拨离间
弄狗相咬→挑拨是非
夫役→挑夫
担水→挑水
唆使→挑唆
拣选→挑撰
层次→条理
条款→条目
条文→条则
便条→条子
跳班→跳级
舞蹈→跳舞
切题→贴题
知心→贴心
推心置腹→贴心贴腹
铁画银钩→铁笔银钩
好汉→铁汉
铁笔银钩→铁画银钩
铁丝网→铁蒺藜
铁面无私→铁面无情
木人石心→铁石心肠
铁蒺藜→铁丝网
人中表表→铁中铮铮
驯伏→帖伏
服从→听从
服从→听命
听其自然→听天由命
天井→庭院
搁笔→停笔
留步→停步
歇工→停工
停顿→停留
停息→停歇
休业→停业
息兵→停战
制止→停止
故步自封→停滞不前
特立→挺拔
屹立→挺立
自告奋勇→挺身而出
转达→通报
透风→通风
告示→通告
通同一气→通合一气
共同努力→通力合作
老例→通例
明亮→通亮
统统→通盘
亨衢→通衢
畅通→通顺
普通→通俗
民间文学→通俗文学
串通→通同
通合一气→通同一气
彻夜→通宵
焚膏继晷→通宵达旦
通达→通晓
通畅→通行
关照→通知
公告→通知布告
搭档→同伴
惺惺相惜→同病相怜
戮力同心→同仇敌忾
翅膀→同党
划一→同等
比量齐观→同等看待
夹杂→同化
朋友→同伙
同寅→同僚
随波逐流→同流合污
患难夫妻→同命鸳鸯
手足同心→同气连枝
同乡→同亲
怜悯→同情
等量齐观→同日而语
煮荳燃萁→同室操戈
同亲→同乡
同心并力→同心合力
一心→同心专心
偕行→同行
同砚→同学
同行→同业
同道→同志
守望相助→同舟共济
同出一脉→同宗同气
浓云→彤云
更鼓敲尽→铜漏滴尽
宝穴→铜山
齐备→统统
同一→统一
放下屠刀→痛改前非
悔恨→痛恨
痛楚→痛苦
疼痛→痛苦悲伤
轸慕→痛念
酸心→痛心
切齿痛恨→痛心疾首
批红判白→偷天换日
鬼鬼祟祟→偷偷摸摸
高人一等→头角峥嵘
蓬头历齿→头童齿豁
条理分明→头头是道
头目→头子
谋利→投机
降服佩服→投降
当兵→投军
投机→投契
探亲→投亲
有所顾忌→投鼠忌器
吐露→透露
表示→透露表现
泄漏天机→透露机密
突出→凸起
秃头→秃顶
忽然→突然
犯上作乱→图谋不轨
犯上作乱→图为不轨
名不副实→徒负虚名
托之空言→徒托空言
分崩离析→土崩瓦解
本地货→土产
地皮→土地
乡俗→土风
土鸡瓦犬→土牛木马
土头土脑→土气
土气→土头土脑
土人→土着土偶
呕吐→吐逆
扬扬得意→吐气扬眉
连合→团结
团圆→团聚
火上浇油→推波助澜
革故鼎新→推陈出新
披肝沥胆→推诚相见
推许→推崇
推测→推断
保举→推荐
推选→推举
推脱→推诿
推测→推想
真心实意→推心置腹
推求→推寻
悲观→颓废
衰年→颓龄
远而避之→退避三舍
退军→退兵
退兵→退军
逊位→退位
解甲归田→退役还乡
腐化→蜕化
吞吐其辞→吞吞吐吐
借口→托言
耽搁→拖延
摆脱→脱节
离开→脱离
动手→脱手
洗手不干→脱胎换骨
妥善→妥帖
开辟→拓荒
詈骂→唾骂
费尽心血→挖空心思
讥诮→挖苦
小人得志→瓦釜雷鸣
污蔑→歪曲
歪七扭八→歪歪扭扭
外地→外埠
表面→外观
外祸→外患
交际→外交
表面→外面
外强中干→外强内弱
别史→外史
外衣→外套
皮毛→外相
生手→外行
门外汉→外行人
外套→外衣
外助→外援
夫君→外子
异族→外族
曲折→弯曲勉强
脱稿→完稿
竣工→完工
齐备→完好
美满→完竣
美满→完满
美满→完善
完备→完整
统统→完整绝对
打趣→玩笑
至死不悟→顽固不化
淘气→顽皮
好似→宛如彷佛
委宛→宛转
劝说→挽劝
暮年→晚年
痛惜→惋惜
阒寂无声→万籁俱寂
全能→万能
千万→万万
十拿九稳→万无一失
归天→亡故
天孙→王孙
今后→往后
来去→往来来往
昔日→往日
每每→往往
徒然→枉然
贪图→妄想
妄语→妄言
井蛙语海→妄自尊大
横行霸道→妄作胡为
忘记→忘掉
不知恩义→忘恩负义
忘却→忘怀
瞠乎其后→望尘莫及
望眼将穿→望穿秋水
望而生畏→望而却步
割肉医疮→望梅止渴
王谢→望族
危急→危机
岌岌可危→危如累卵
伤害→危险
骇人听闻→危言耸听
端坐→危坐
坚毅不拔→威武不屈
低微→微贱
玄妙→微妙
薄弱→微弱
大公无私→为国损躯
包围→围困
帆樯→桅竿
栩栩如生→维妙维肖
假票→伪钞
委果→委的
疲劳→委靡
委曲→委屈
宛转→委宛
婉转→委婉
不便→未便
无可非议→未可厚非
将来→未来
他日→未来畴昔
暖和→温顺
温和→温文
文质彬彬→温文尔雅
暖和→温煦
纸墨笔砚→文房四宝
掩罪藏恶→文过饰非
娴静→文静
词句→文句
温文尔雅→文质彬彬
笔墨→文字
闻风而逃→闻风而动
闻风而动→闻风远扬
改过自新→闻过则喜
符合→吻合
混乱→紊乱
妥当→稳当
妥当→稳健
固若金汤→稳如泰山
题目→问题
心安理得→问心无愧
胜券在握→瓮中捉鳖
寝室→卧室
黝黑→乌黑
一塌糊涂→乌烟瘴气
腌臜→污秽
贪吏→污吏
臭名→污名
浑浊→污浊
毁谤→诬蔑
杜撰→诬捏
不足为奇→无独有偶
横行霸道→无法无天
可有可无→无关紧要
价值千金→无价之宝
未可厚非→无可非议
完好→无缺
漠视→无视
见义勇为→无所畏惧
碌碌无为→无所作为
池鱼之殃→无妄之灾
天真→无邪
自作掩饰→无懈可击
偶然→无意
偶然→无意偶尔
高枕而卧→无忧无虑
忠于职守→毋忝厥职
荒废→芜秽
冗杂→芜杂
八门五花→五花八门
中午→午时
昼寝→午睡
半夜→午夜
军人→武士
轻渎→侮慢
归天→物化
偏差→误差
负约→误期
见面→晤面
若明若暗→雾里看花
弄堂→衖堂
扑灭→袪除
斜阳→夕阳
落日→夕照
洋装→西服
泰西→西洋
吸取→吸收
特别→希奇
当年→昔时
扑灭→息灭
息款→息钱
相安无事→息事宁人
痛痒相关→息息相关
和解→息争
捐躯→牺牲
全部→悉数
淡薄→稀薄
特别→稀奇
希罕→稀疏
有数→稀有
门庭若市→熙熙攘攘
油腔滑调→嘻皮笑脸
风俗→习惯
屡见不鲜→习以为常
打击→袭击
倾耳细听→洗耳恭听
改过自新→洗心革面
沐浴→洗澡
喜好→喜爱
大喜过望→喜出望外
喜欢→喜好
喜好→喜欢
笑剧→喜剧
春风得意→喜气洋洋
兴高采烈→喜上眉梢
厌旧喜新→喜新厌旧
喜讯→喜信
喜信→喜讯
乐陶陶→喜洋洋
高兴→喜悦
吉兆→喜兆
笑逐颜开→喜逐颜开
精密→细密
详目→细目
精致→细腻
金饰→细软
零碎→细碎
渺小→细微
微小→细小
小星→细姨
小雨→细雨
瞎说→瞎扯
局促→狭隘
局促→狭窄
放工→下班
基层→下层
了局→下场
劣等→下等
下游→下流
着落→下落
来世→下世
动手→下手
放学→下学
卑鄙→下游
下午→下战书
下午→下昼
部属→下属
夏日→夏季
农历→夏历
夏季→夏日
炎天→夏天
品格清高→仙风道骨
瑶池→仙境
神仙→仙人
先进→先辈
前锋→先锋
先辈→先进
预言家→先觉
老师→先生
天赋→先天
翻开→掀开
光显→鲜明
美丽→鲜艳
金衣玉食→鲜衣美食
漫谈→闲谈
空隙→闲暇
散逸→闲逸
贤能→贤达
贤能→贤良
贤达→贤能
奉命→衔命
怀疑→嫌疑
闻达→显达
权贵→显贵
表现→显露
崭露锋芒→显露头角
表现→显示
展现→显现
贵显→显要
明显→显着
邪恶→险恶
险要→险峻
险路→险途
刁滑→险诈
当代→现代
实际→现实
征象→现象
如今→现在
近况→现状
限期→限日
限定→限制
沦陷→陷落
沉迷→陷溺
倾慕→羡慕
墟落→乡村
乡下→乡间
乡间→乡下
州里→乡镇
相称→相等
邂逅→相逢
符合→相符
干系→相干
量体裁衣→相机行事
相知恨晚→相见恨晚
举案齐眉→相敬如宾
雷同→相通
信赖→相信
相见恨晚→相知恨晚
香喷喷→香馥馥
香馥馥→香喷喷
配房→厢房
细致→详尽
详确→详实
细致→详细
吉祥→祥瑞
纳福→享福
盗贼→响马
相应→响应
费尽心机→想方设法
缅怀→想念
领导→向导
朝阳→向阳
小路→巷子
落发→削发
跌价→削价
减少→削减
斲丧→消耗
悲观→消极
消除→消弭
清除→消灭
溶解→消融
偃旗息鼓→消声匿迹
瘦弱→消瘦
刻舟求剑→萧规曹随
飘逸→萧洒
冷落→萧瑟
荒凉→萧疏
冷落→萧索
冷落→萧条
鸣金收兵→销声匿迹
贩卖→销售
天悬地隔→霄壤之别
跋扈→嚣张
末节→小节
鄙视→小看
细姨→小老婆
巷子→小路
奶名→小名
鄙吝→小器
计无所出→小手小脚
幼童→小童
个人→小我
胆小如鼠→小心谨慎
战战兢兢→小心翼翼
明白→晓畅
凶服→孝服
孝敬→孝顺
结果→效果
服从→效率
服从→效用
订正→校勘
口蜜腹剑→笑里藏刀
笑貌→笑脸
眉开眼笑→笑容可掬
笑哈哈→笑嘻嘻
眉飞色舞→笑逐颜开
休息→歇息
停业→歇业
同心并力→协力同心
帮忙→协助
险恶→邪恶
歧途→邪路
克制→胁制
夕阳→斜阳
通力进行→携手合作
满意→写意
走漏→泄漏
灰心→泄气
推辞→谢绝
和缓→懈弛
怠惰→懈怠
问心无愧→心安理得
漫不经心→心不在焉
心乱如麻→心烦意乱
心折→心服
毫不勉强→心甘情愿
兴高采烈→心花怒放
包藏祸心→心怀叵测
方寸已乱→心慌意乱
灰心丧气→心灰意懒
意气消沉→心灰意冷
心机→心计心情
闻风丧胆→心惊胆战
提心吊胆→心惊肉跳
赏心悦目→心旷神怡
内心→心里
生理→心理
心心相印→心领神会
心烦意乱→心乱如麻
得偿所愿→心满意足
平心静气→心平气和
痛澈心脾→心如刀割
心猿意马→心神不定
心猿意马→心神恍惚
聚精会神→心神专注
心伤→心酸
默算→心算
息息相通→心心相印
心神不定→心猿意马
直肚直肠→心直口快
胸有定见→心中有数
费力→辛苦
辛劳→辛勤
酸楚→辛酸
复活→新生
奇怪→新鲜
月牙→新月
漫步→信步
言三语四→信口雌黄
天花乱坠→信口开河
信托→信任
名誉→信用
发兵→兴兵
愉快→兴奋
欢欣鼓舞→兴高采烈
茂盛→兴隆
鼓起→兴起
郁勃→兴盛
发兵→兴师
调兵遣将→兴师动众
兴致索然→兴味索然
兴高采烈→兴致勃勃
分离→星散
侦缉队→刑警队
举措→行动
贿赂→行贿
利用→行使
举动→行为
去处→行止
形影相吊→形单影只
玄学→形而上学
鸠形鹄面→形容枯槁
形容枯槁→形销骨立
形影相随→形影不离
孓然一身→形影相吊
觉醒→醒觉
夺目→醒目
觉醒→醒悟
性子→性质
凶恶→凶暴
横暴→凶残
凶险→凶恶
孝服→凶服
暴虐→凶狠
暴虐→凶横
猛烈→凶猛
荒年→凶年
丧事→凶事
凶恶→凶险
凶讯→凶信
恶兆→凶兆
目不识丁→胸无点墨
胸中有数→胸有成竹
匠意于心→胸中有数
丰富→雄厚
气昂昂→雄赳赳
雄心壮志→雄心勃勃
壮志凌云→雄心万丈
雄心勃勃→雄心壮志
富丽→雄壮
痛痒相关→休戚相关
苏息→休息
停业→休业
停战→休战
停止→休止
修睦→修好
构筑→修建
补缀→修理
补葺→修缮
羞辱→羞耻
羞涩→羞怯
羞耻→羞辱
美丽→秀丽
男子→须眉
假造→虚构
浪费→虚耗
浮名→虚名
假造→虚拟
卖弄→虚伪
客气→虚心
外强中干→虚有其表
假意周旋→虚与委蛇
矫揉造作→虚张声势
必要→需要
缓步→徐行
缓缓→徐徐
很多→许多
答应→许诺
朝阳→旭日
方兴未艾→旭日东升
媒介→序言
唠叨→絮聒
絮絮叨叨→絮絮不休
积蓄→蓄积
媾和→宣战
喧嚣→喧哗
闹热热烈繁华→喧闹
哗闹→喧嚣
牵挂→悬念
推举→选举
辉煌光耀→绚烂
才高八斗→学富五车
门生→学生
雪恨→雪耻
落井下石→雪上加霜
含血喷人→血口喷人
血流成河→血流漂杵
平凡→寻常
探求→寻找
顺从→驯服
和善→驯良
扣问→询问
循规蹈矩→循序渐进
谆谆教导→循循善诱
谴责→训斥
就义→殉国
压倒→压服
克制→压迫
克制→压抑
阒寂无声→鸦雀无声
默不作声→哑口无言
都雅→雅观
高雅→雅致
耽误→延迟
耽搁→延宕
连续→延续
重办→严惩
隆冬→严冬
严酷→严格
冰冷→严寒
严厉→严峻
严格→严酷
精密→严密
严正→严明
盛食厉兵→严阵以待
严明→严正
紧张→严重
一针见血→言必有中
心口不一→言不由衷
执法如山→言出法随
出尔反尔→言而无信
三言两语→言简意赅
百依百顺→言听计从
口是心非→言行相诡
相沿→沿袭
相沿→沿用
酷热→炎热
酷暑→炎暑
夏天→炎天
酷暑→炎夏
岌岌可危→奄奄一息
掩饰笼罩→掩盖
面前目今→眼前
练习→演习
讨厌→厌恶
讨厌→厌烦
鄙弃→厌弃
美丽→艳丽
鱼雁不绝→雁足传书
曲折小路→羊肠小道
绣花枕头→羊质虎皮
两面三刀→阳奉阴违
阳世→阳间
阳间→阳世
意气扬扬→洋洋得意
仰食→仰给
俯仰由人→仰人鼻息
瞻仰→仰视
瞻仰→仰望
养痈成患→养虎遗患
养痈遗患→养痈成患
养虎伤身→养痈遗患
约请→邀请
摇荡→摇摆
乞哀告怜→摇尾乞怜
风雨飘摇→摇摇欲坠
摇荡→摇曳
迢遥→遥远
句斟字嚼→咬文嚼字
痛心疾首→咬牙切齿
妙手回春→药到病除
妙手回春→药到回春
针砭之语→药石之言
大概→也许
别史→野史
田野→野外
更阑→夜阑
屁滚尿流→一败涂地
一样平常→一般
不苟言笑→一本正经
明哲保身→一尘不染
刻舟求剑→一成不变
束手无策→一筹莫展
一挥而就→一蹴而就
薪尽火灭→一刀两断
肯定→一定
岌岌可危→一发千钧
一向→一贯
一呼百应→一呼百诺
一下子→一会儿
一石二鸟→一举两得
屁滚尿流→一蹶不振
一得之愚→一孔之见
一清二楚→一览无余
连续→一连
一起→一路
同等→一律
江河日下→一落千丈
爱财如命→一毛不拔
一壁→一面
千篇一律→一模一样
一览无余→一目了然
贫无立锥→一贫如洗
趁热打铁→一气呵成
一尘不染→一乾二净
一无所知→一窍不通
统统→一切
与日俱增→一日千里
临时→一时
等量齐观→一视同仁
金瓯无缺→一统天下
一扫而空→一网打尽
勇往直前→一往无前
别无长物→一无长物
一无是处→一无可取
一无可取→一无是处
一无所获→一无所得
一无所得→一无所获
空空如也→一无所有
一直→一向
付之一笑→一笑置之
同心同德→一心一德
全心全意→一心一意
三言两语→一言半语
一声不响→一言不发
说一是一→一言为定
逐一→一一
独断专行→一意孤行
包罗万象→一应俱全
刀刀见血→一语破的
频频→一再
刀刀见血→一针见血
一孔之见→一知半解
不停→一直
同等→一致
大夫→医生
允从→依从
仍旧→依旧
寄托→依靠
留恋→依恋
为人作嫁→依人篱下
维持原状→依样葫芦
践约→依约
移船就磡→移樽就教
忘记→遗忘
迷惑→疑惑
困惑→疑心
曩昔→以前
以牙还牙→以眼还眼
依附→倚赖
义军→义兵
当仁不让→义不容辞
义师→义军
义军→义师
当仁不让→义无反顾
理直气壮→义正词严
理直气壮→义正辞严
媾和→议和
马首是瞻→亦步亦趋
非常→异常
众口一词→异口同声
他日→异日
他乡→异乡
贰言→异议
他乡→异域
外族→异族
烦闷→抑郁
轻而易举→易如反掌
好处→益处
良朋→益友
料想→意料
不测→意外
弦外之音→意在言外
求学→肄业
揣测→臆测
随机应变→因地制宜
马马虎虎→因陋就简
随机应变→因时制宜
由于→因为
相沿→因袭
抱残守缺→因循守旧
剖腹藏珠→因噎废食
暗沟→阴沟
阴暗→阴晦
农历→阴历
鬼域伎俩→阴谋诡计
凶险→阴险
黑暗→阴郁
周到→殷勤
富商→殷商
旁征博引→引经据典
弁言→引言
贪污舞弊→饮马投钱
哭泣→饮泣
潜伏→隐蔽
遏恶扬善→隐恶扬善
忌讳→隐讳
遮盖→隐瞒
秘密→隐秘
躲避→隐匿
哑忍→隐忍
隐隐→隐约
答允→应承
应付自如→应付裕如
应付裕如→应付自如
当机立断→应机立断
合时→应时
答应→应许
包罗万象→应有尽有
答应→应允
欢迎→迎接
劈面→迎面
奋起直追→迎头赶上
红利→盈利
红利→盈余
假公济私→营私舞弊
业务→营业
颖悟→颖慧
颖慧→颖悟
附和→拥护
杞人忧天→庸人自扰
卑鄙→庸俗
栗六庸才→庸庸碌碌
痴肥→臃肿
永世→永久
永久→永远
不屈不挠→勇往直前
勤奋→用功
埋头→用心
厚待→优待
头等→优等
好处→优点
柔嫩→优柔
心神不定→优柔寡断
上风→优势
良好→优秀
优秀→优异
富足→优裕
厚待→优遇
良好→优越
苦恼→忧?
哀愁→忧愁
伤时感事→忧国忧民
担心→忧虑
忧愁→忧闷
难过→忧伤
忧心如捣→忧心忡忡
忧心如捣→忧心如焚
担心→忧郁
昏暗→幽暗
深谷→幽谷
寂静→幽静
久长→悠久
清闲→悠闲
夷由→犹豫
心神不定→犹豫不决
调皮→油滑
嘻皮笑脸→油腔滑调
油嘴滑舌→油头滑脑
吊儿郎当→游手好闲
嬉戏→游玩
迟疑→游移
盟国→友邦
朋侪→友人
和睦→友善
交情→友谊
绘声绘色→有板有眼
防患未然→有备无患
对症下药→有的放矢
口碑载道→有口皆碑
百辞莫辩→有口难言
名不副实→有名无实
风趣→有趣
绘声绘色→有声有色
偶然→有时
虎头蛇尾→有始无终
善始善终→有始有终
井井有条→有条不紊
有声有色→有条有理
虎头蛇尾→有头无尾
善始善终→有头有尾
有用→有效
故意→有心
故意→有意
有效→有用
稚子→幼稚
勾引→诱惑
转弯抹角→迂回曲折
空闲→余暇
宽裕→余裕
雁足传书→鱼雁不绝
愚昧→愚笨
痴顽→愚钝
鄙意→愚见
屈曲→愚昧
呆笨→愚拙
同流合污→与世浮沉
颠三倒四→语无伦次
苦口婆心→语重心长
财宝→玉帛
忧郁→郁闷
愁闷→郁悒
预支→预付
初赛→预赛
拔苗助长→欲速不达
宽裕→裕如
罹难→遇难
德配→元配
首恶→元凶
本来→原本
本籍→原籍
包涵→原谅
质料→原料
暴露无遗→原形毕露
缘故原由→原因
起因→原由
光滑油滑→圆滑
救济→援助
刻舟求剑→缘木求鱼
长途→远程
宏大→远大
太古→远古
阔别→远离
痛恨→怨恨
怨天恨地→怨天尤人
乐意→愿意
大抵→约略
月尾→月底
玉轮→月亮
月晦→月终
动听→悦耳
好看→悦目
天悬地隔→云泥之别
许诺→允诺
昏迷→晕厥
积聚→蕴蓄
熟练→谙练
谙习→谙熟
老马识途→谙熟门路
熟练→闇练
翱翔→遨游
飞行→遨游飞翔
龟婆→鸨母
羽缎→哔叽
梅香→婢女
璧赵→璧还
透骨→砭骨
火急→弁急
礼帽→弁冕
小序→弁言
搏命→拚命
遵奉→禀承
天禀→禀赋
摈弃→摒除
料理→摒挡
放弃→摒弃
访拿→跴缉
凡夫俗子→伧夫俗人
喧华→嘈吵
哗闹→嘈吵喧斗
喧华→嘈杂
怜悯→恻隐
冷静→岑寂
高峰→岑岭
羸弱→孱羸
羸弱→孱弱
阿谀→谄谀
后悔→忏悔
北里→娼寮
徘徊→徜徉
痛恨→怅恨
痛惜→怅然
怅惜→怅惋
惋惜→怅惘
怅惋→怅惜
张口结舌→瞠目结舌
讽刺→嗤笑
剥夺→褫夺
免职→褫职
叱喝→叱呵
叱呵→叱喝
谩骂→叱骂
气吞山河→叱咤风云
戒勉→饬厉
命令→饬令
命令→敕令
难过→惆怅
不对→舛错
不对→舛讹
不对→舛误
惊惶失措→猝不及防
蓦地→猝然
揣测→忖测
揣测→忖度
思念→忖量
前思后想→忖前思后
殚精竭虑→殚思极虑
殚精竭虑→殚智竭力
恬淡→澹泊
沾光→叨光
讨教→叨教
忝在爱末→叨在知己
雕琢→砥砺
擎天一柱→砥柱中流
注视→谛视
细听→谛听
顶峰→巅峰
不可一世→咄咄逼人
近来→迩来
茂盛→蕃昌
茂盛→蕃芜
茂盛→蕃庑
繁生→蕃殖
头陀→梵衲
佛寺→梵刹
佛学→梵学
佛寺→梵宇
好像→彷佛
徘徊歧路→彷徨歧途
配头→妃耦
闲言闲语→蜚短流长
浮言→蜚言
流言→蜚语
勃然变色→怫然作色
愤懑→怫郁
螳臂挡车→蜉蝣撼树
怒不可遏→拊膺切齿
渊博→赅博
难堪→尴尬
作对→尴尬刁难
空前未有→亘古未有
不断→赓续
黑白→诟谇
讲和→媾和
车水马龙→毂击肩摩
都门→毂下
伫候→鹄候
伫立→鹄立
盲人→瞽者
蛮横→犷悍
点头→颔首
点头答应→颔首应承
通同一气→沆瀣一气
白发苍颜→皓首苍颜
斥骂→诃斥
学校→黉舍
不求甚解→囫囵吞枣
哆嗦→觳觫
谋生→餬口
恶性难改→怙恶不悛
父母→怙恃
跟从→扈从
盗贼四起→萑苻不靖
市集→阛阓
天地→寰宇
弁急→遑急
幽默→诙谐
滑稽突梯→诙谐百出
照耀→晖映
集合→荟萃
花名→诨名
名片→咭片
抱恨→赍恨
拘束→羁绊
拉拢→羁糜
笼络→羁縻
监禁→羁系
间不容发→岌岌可危
杀戮→殛毙
区区→戋戋
洗雪→湔雪
困阻→蹇滞
姣美→姣好
俊俏→姣美
胶葛→轇轕
鹤立鸡群→佼佼不群
洁白→皎白
洁白→皎洁
洁白→皎洁皎洁
太息→嗟叹
孤单→孑立
形单影只→孑然一身
余存→孑遗
揭发→讦发
揭发→讦扬
驳诘→诘难
诘责→诘问
指责→诘问诘责
揭发→诘扬
诘问→诘责
窘迫→拮据
蛮横→桀骛
狡猾→桀黠
凶悍→桀
自持→矜持
怜惜→矜恤
端庄→矜重
绅耆→缙绅
默不作声→噤若寒蝉
牝牡骊黄→泾渭不分
旗帜→旌旗
信号→旌旗灯号
觉悟→憬悟
判然不同→迥然不同
特别→迥殊
集合→鸠合
纠率→鸠率
急变→遽变
忽然→遽然
丝毫→涓滴
雕刻→镌刻
淘汰→镌汰
恳→镌谕
清高→狷介
形影相吊→孓然一身
其后→厥后
冷炙→馂余
夫妇→伉俪
劳军→犒军
赏赐→犒赏
敬慎→恪慎
服从→恪守
忽然→溘然
撒手尘寰→溘然长逝
打门→叩门
叩头→叩首
叩首→叩头
道谢→叩谢
到处颂扬→脍炙人口
欺骗→诳骗
大话→诳言
闺范→阃范
絮聒→唠叨
刺刺不休→唠唠叨叨
牢狱→缧绁
孱弱→羸弱
阳关三迭→骊歌高唱
抱病→罹病
遭灾→罹难
鄙谚→俚语
到临→莅临
践祚→莅祚
唾骂→詈骂
洪亮→嘹亮
狼籍→缭乱
选派→遴派
挑选→遴选
践踏→辚轹
欣赏→浏览
走狗→喽啰
详述→胪陈
摆列→胪列
麋集→辘集
闾阎→闾里
闾里→闾阎
比翼双飞→鸾凤和鸣
笔走龙蛇→鸾翔凤翥
摩拳擦掌→捋臂将拳
蠢蠢欲动→捋臂张拳
昏瞶→颟顸
抚心→扪心
抚躬自问→扪心自问
昏黄→朦胧
聪明一世→懵懂一时
秋扇见捐→蘼芜路断
伏羲→宓羲
微不足道→眇乎小哉
渺小→眇小
淹没消灭→泯没
淹灭→泯灭
明器→冥具
明器→冥器
猛然→蓦地
蓦地→蓦然
眼珠→眸子
衣冠禽兽→沐猴而冠
假日→沐日
吸风饮露→沐雨栉风
洗浴→沐浴
过去→曩昔
内疚→忸怩
惭愧→忸捏
歌唱→讴歌
滂沱→滂湃
滂湃→滂沱
倾盆大雨→滂沱大雨
取代→庖代
火头→庖丁
宓羲→庖羲
马虎→纰漏
不对→纰谬
螳臂挡车→蚍蜉撼树
战云浓密→鼙鼓雷鸣
离异→仳离
屏绝→圮绝
顾盼→睥睨
四六文→骈体文
慓悍→剽悍
冶游→嫖妓
愁眉不展→颦眉促额
雌雄→牝牡
泾渭不分→牝牡骊黄
膝行→匍匐
靡靡之音→濮上之音
细长→颀长
庸人自扰→杞人忧天
鳃鳃过虑→杞天之忧
富丽→绮丽
年轻貌美→绮年玉貌
绮襦纨裤→绮绮子弟
绮绮子弟→绮襦纨裤
休憩→憩息
吝啬→悭吝
图章→钤记
虔敬→虔诚
虔诚→虔敬
经纪→掮客
缠绵→缱绻
杀害→戕害
角楼→谯楼
干瘪→憔悴
满意→惬心
满意→惬意
坚持不懈→锲而不舍
蹀躞→踥蹀
独居→茕居
消灭→祛除
鸦雀无声→阒寂无声
改过→悛改
解释→诠释
柔弱→荏弱
沥血以誓→歃血为盟
毁谤→讪谤
讽刺→讪笑
空中楼阁→蜃楼海市
种花→莳花
种植→莳植
打猎→狩猎
突然→倏忽
寡妇→孀妇
寡居→孀居
胡混→厮混
广博→汜博
令出必行→驷不及舌
伺隙→俟机
惶恐→悚惶
挑拨→嗾使
早起→夙起
前世怨仇→夙世冤家
从前→夙昔
早起→夙兴
旦夕→夙夜迟早
太古→邃古
精细→邃密
精密→邃密精美
明白→邃晓
寻思→覃思
七上八下→忐忑不定
闭门不出→韬光养晦
闭门不出→韬匮藏珠
叨在知己→忝在爱末
浮薄→佻达
虐待→荼毒
公子王孙→纨子弟
打狗不看主人面→罔顾情面
高大→嵬峨
退却→猬缩
娇媚→妩媚
违逆→忤逆
调侃→奚弄
喜笑颜开→嬉皮笑脸
缺点→瑕玷
文静→娴静
闲雅→娴雅
芳泽→芗泽
清闲→逍遥
逃出法网→逍遥法外
飘逸→潇洒
轻渎→亵渎
宛在目前→栩栩如生
徇私舞弊→徇情枉法
拔苗助长→揠苗助长
埋没→湮没
泯没→湮灭
鸣金收兵→偃旗息鼓
闷闷不乐→怏怏不乐
短命→夭折
悠然自得→怡然自得
阻塞→壅塞
咕咕唧唧→喁喁细语
败类→莠民
吹嘘→揄扬
混乱→杂沓
混居→杂居
乱七八糟→杂乱无章
磨难→灾祸
灾祸→灾难
种植→栽培
种植→栽种
重版→再版
再见→再会
不屈不挠→再接再厉
执政→在朝
活着→在世
临时→暂且
临时→暂时
停息→暂停
称赞→赞美
歌颂→赞颂
歌颂→赞叹
附和→赞同
赞同→赞许
歌颂→赞扬
表彰→赞誉
摧残浪费蹂躏→糟蹋
清晨→早晨
从前→早年
朝霞→早霞
作育→造就
不法→造孽
暴躁→躁急
叱责→责备
惩罚→责罚
求全谴责→责怪
求全谴责→责骂
求全谴责→责难
补充→增补
增长→增进
讨厌→憎恶
痛恨→憎恨
奉送→赠给
奉送→赠送
踏实→扎实
安营→扎营
压迫→榨取
择要→摘要
局促→窄小
借主→债主
志得意满→沾沾自喜
浓厚→粘稠
展望→瞻望
仰望→瞻仰
鸡犬不留→斩草除根
刀切斧砍→斩钉截铁
睁开→展开
预测→展望
显现→展现
崭露锋芒→崭露头角
极新→崭新
霸占→占领
占据→占有
败北→战败
兵士→战士
百战百胜→战无不胜
小心翼翼→战战兢兢
伸开→张开
默不作声→张口结舌
宣扬→张扬
蛇头鼠眼→獐头鼠目
狐假虎威→仗势欺人
慷慨解囊→仗义疏财
停滞→障碍
招抚→招安
雇用→招聘
申雪→昭雪
调集→召集
还是→照旧
如法泡制→照猫画虎
还是→照样
起始→肇端
掩藏→遮蔽
遮掩→遮盖
掩蔽→遮掩
半数→折半
赔本→折本
扣头→折扣
折衷→折中
冬眠→蛰伏
如许→这样
纯洁→贞洁
箴规→针砭
刑警队→侦缉队
保护→珍爱
宝贵→珍贵
怜惜→珍视
爱惜→珍惜
珍奇→珍异
朴拙→真诚
实话→真话
原形→真相
至心→真心
全心全意→真心实意
奋发→振奋
冷静→镇定
竟日→镇日
弹压→镇压
辩论→争吵
辩论→争持
夺取→争取
抢先→争先
辩论→争执
征请→征聘
展开→睁开
如日方升→蒸蒸日上
救济→拯救
划一→整齐
团体→整体
本来→正本
正直→正大
光明磊落→正大光明
恰好→正好
态度严肃→正襟危坐
端庄→正经
正途→正路
精确→正确
君子→正人
正派人物→正人君子
重视→正视
发妻→正室
正路→正途
中午→正午
疾言厉色→正言厉色
公理→正义
端正→正直
守正不阿→正直无私
谨慎→郑重
当局→政府
付出→支出
付出→支付
分崩离析→支离破碎
着名→知名
功成身退→知难而退
满足→知足
至死不渝→执迷不悟
实行→执行
在朝→执政
切谏→直谏
刀切斧砍→直截了当
挺立→直立
坦直→直爽
嫡系→直系
开门见山→直言不讳
批评→指斥
引导→指导
辅导→指点
控告→指控
颠倒黑白→指鹿为马
指鸡骂犬→指桑骂槐
教唆→指使
责怪→指责
批评→指摘
自鸣得意→趾高气扬
珍宝→至宝
兰交→至好
至好→至交
嫡亲→至亲
顽固不化→至死不悟
同舟共济→志同道合
订定→制定
礼服→制服
成品→制品
克制→制止
淳厚→质朴
诘责→质问
停滞→窒碍
伶俐→智慧
拖泥带水→滞滞泥泥
视而不见→置若罔闻
置之不理→置之度外
停止→中断
中心→中间
诽谤→中伤
入耳→中听
中间→中心
复兴→中兴
中间→中央
针砭箴规→忠告
忠实→忠厚
老实→忠实
赤胆忠心→忠心耿耿
忠告→忠言
尽头→终点
闭幕→终结
结局→终局
停止→终了
停止→终止
莳植→种植
浩繁→众多
众寡不敌→众寡悬殊
众说纷纭→众口纷纭
异口同声→众口一词
大庭广众→众目睽睽
众志成城→众擎易举
众口纷纭→众说纷纭
众擎易举→众志成城
庞大→重大
相逢→重逢
重修→重建
厚利→重利
紧张→重要
大张旗鼓→重振旗鼓
全面→周全
四周→周围
精密→周详
唾骂→咒骂
蓦地→骤然
豪门→朱门
红颜→朱颜
苟求不已→诛求无厌
渐渐→逐步
渐渐→逐渐
主理→主办
正犯→主犯
骨干→主干
方丈→住持
停止→住手
留宿→住宿
助势→助威
助桀为虐→助纣为虐
表明→注解
解释→注释
刊出→注销
细致→注意
看重→注重
储备→贮备
庆贺→祝贺
捉住→抓住
特地→专程
跋扈→专横
埋头→专心
全心全意→专心致志
埋头→专一
变化→转变
放晴→转晴
须臾→转瞬
迂回曲折→转弯抹角
迁移转变→转折
赢利→赚钱
尊严→庄严
端庄→庄重
装置→装配
矫健→壮健
雄心万丈→壮志凌云
定时→准时
答应→准许
卓识→卓见
杰出→卓异
杰出→卓越
笨拙→拙笨
秃笔→拙笔
鄙见→拙见
左支右绌→捉襟见肘
污流→浊流
发急→着急
动手→着手
罄竹难书→擢发难数
细致→仔细
勤学不辍→孜孜不倦
润泽→滋润
后代→子女
虚假→子虚
半夜→子夜
辅音→子音
自信→自傲
自卑过甚→自暴自弃
自感汗颜→自惭形秽
别出心裁→自出机杼
自负→自大
袒自若→自得其乐
自觉→自发
自尊→自负
苟且偷安→自甘堕落
目空一切→自高自大
挺身而出→自告奋勇
自身难保→自顾不暇
自大→自豪
本身→自己
自发→自觉
自感汗颜→自愧弗如
独立→自力
白手起家→自力更生
自主→自立
得意→自满
得意洋洋→自鸣得意
孤芳自赏→自命不凡
发奋图强→自强不息
咎由自取→自取其祸
自若→自如
自尽→自杀
白手起家→自食其力
利欲熏心→自私自利
自坠陷阱→自投罗网
自大→自信
自作掩饰→自圆其说
怨天尤人→自怨自艾
志愿→自愿
从容→自在
自负→自尊
作法自毙→自作自受
统共→总共
统辖→总揽
泛论→总论
直通→纵贯
放纵→纵容
浮光掠影→走马看花
私运→走私
断港绝潢→走头无路
断港绝潢→走投无路
交运→走运
见效→奏效
充足→足够
毕业→卒业
拦阻→阻碍
拦截→阻挡
隔绝→阻遏
隔绝→阻隔
阻当→阻梗
拦阻→阻截
拦阻→阻拦
拦阻→阻挠
壅闭→阻塞
制止→阻止
停滞→阻滞
构成→组成
构造→组织
故国→祖国
本籍→祖籍
先人→祖先
研讨→钻研
末了→最后
近来→最近
开始→最先
终极→最终
罪大恶极→罪不容诛
罪不容诛→罪大恶极
罪过→罪恶
罪不容诛→罪该万死
罪行→罪过
罪大恶极→罪孽深重
犯人→罪人
恶行→罪行
咎由自取→罪有应得
灯红酒绿→醉生梦死
倾慕→醉心
敬服→尊崇
府上→尊府
高贵→尊贵
恭敬→尊重
服从→遵命
服从→遵守
遵照→遵循
依照→遵照
节流→撙节
八面玲珑→左右逢源
捉襟见肘→左支右绌
袖手旁观→作壁上观
尴尬刁难→作对
作歹→作恶
自作自受→作法自毙
取消→作废
去世→作古
横行霸道→作奸犯科
反叛→作乱
出声→作声
飞扬跋扈→作威作福
冷眼旁观→坐观成败
管中窥豹→坐井观天
下狱→坐牢
过后行兵→坐失良机
诚惶诚恐→坐卧不安
不劳而获→坐享其成
漫谈→座谈
办事→做事
造作→做作
AV女优→***
奸淫→***
立刻→马上
天涯→天边
结实→坚固
轻巧→轻便
注意→注重
立刻→连忙                
著名→闻名
恐惧→惧怕
天涯→天际
打扮→妆扮
轻蔑→轻视
优美→美丽
恶搞→恶搞
抵抗→反抗
舒服→舒适
茂盛→繁茂
生机→生气
防备→预防
严峻→严肃
特殊→非凡
好人→大好人